95 95 53 53 95 54 95 54 95 95 95 57 53 53 53 53 53 95 95 95 53 95 53 95 95 53 53 53 53 53 53 53 53 95 95 95 95 95 95 95 95 95 95 95 95 95 95 95 95 95 
95 95 54 95 53 95 54 54 95 95 95 53 53 53 95 95 95 95 95 95 95 95 95 53 95 95 57 95 53 53 53 53 53 53 53 95 53 58 56 95 95 95 95 95 95 95 95 95 95 95 
95 53 95 95 95 53 53 95 95 53 53 53 95 95 95 95 95 95 95 95 95 95 53 95 95 95 95 53 53 53 53 53 53 96 53 53 53 53 53 95 95 95 95 56 95 95 95 95 95 95 
57 53 95 95 57 57 95 95 95 95 95 95 95 95 95 95 95 95 53 53 56 95 53 57 95 53 58 96 96 96 53 53 96 96 96 96 53 58 53 95 53 53 95 56 53 95 95 53 95 95 
95 95 53 95 95 54 95 95 53 96 96 95 95 95 95 95 95 96 95 58 95 95 95 57 58 96 96 96 96 96 96 96 96 96 96 96 96 53 53 96 96 96 56 56 56 56 95 95 95 95 
53 95 95 53 95 95 95 95 96 96 96 96 96 95 95 95 96 96 96 96 96 95 53 96 96 96 96 96 96 96 96 96 96 96 96 96 96 96 96 96 96 96 96 96 95 56 95 95 95 95 
53 95 95 95 95 95 95 95 96 96 96 96 96 96 96 96 96 96 96 96 96 96 96 96 96 96 96 96 96 96 96 96 96 96 96 96 96 96 96 96 96 96 96 96 96 95 95 95 95 95 
95 95 95 95 95 95 95 96 96 96 96 96 96 96 96 96 96 96 96 96 96 96 96 96 96 96 96 96 96 96 96 96 96 96 96 96 96 96 96 96 96 96 96 96 95 95 95 95 95 95 
57 57 95 95 95 95 96 96 96 96 96 96 96 96 96 96 96 96 96 96 96 96 96 96 96 96 96 96 96 96 96 96 96 96 96 96 96 96 96 96 96 96 96 95 95 95 56 53 95 95 
95 95 95 95 95 95 96 96 96 96 96 96 96 53 55 95 53 95 53 56 95 96 96 96 96 96 96 96 96 96 96 96 96 96 96 96 96 96 96 96 96 96 96 95 95 95 95 95 95 95 
95 95 95 95 95 95 95 96 96 96 96 119 68 68 95 68 95 95 68 68 68 58 68 96 96 96 53 95 95 68 53 95 57 95 95 54 96 96 96 96 96 96 96 95 95 95 95 95 95 95 
95 95 95 95 95 95 95 96 96 96 96 68 95 68 68 68 53 53 53 54 68 68 68 68 96 96 96 95 95 58 95 95 95 94 59 80 54 53 36 96 96 96 96 96 95 95 95 54 95 95 
95 95 95 56 95 96 96 96 96 96 96 68 53 68 53 53 53 58 68 80 73 68 68 68 68 96 96 53 58 95 53 95 53 55 87 95 95 68 96 96 96 96 96 96 96 95 95 95 95 95 
95 95 95 95 95 96 96 96 96 96 96 68 68 53 68 53 68 68 68 87 87 68 55 68 68 96 96 68 66 80 53 95 95 95 53 58 95 95 96 96 96 96 96 96 96 53 95 53 95 95 
95 95 95 95 96 96 96 96 96 96 96 95 53 53 68 68 58 68 68 53 68 53 58 68 68 96 96 96 68 73 95 53 95 95 95 53 53 53 96 96 96 96 96 96 96 53 95 95 95 95 
95 95 95 95 96 96 96 96 96 96 96 95 55 68 68 68 68 68 68 68 58 53 53 68 68 96 96 96 53 56 95 95 95 53 95 95 58 95 54 96 96 96 96 96 96 53 95 95 95 95 
95 95 95 95 95 96 96 96 96 96 96 95 68 55 68 54 53 68 68 68 55 68 53 55 68 96 96 96 53 55 95 95 95 57 55 59 73 95 95 96 96 96 96 95 95 95 53 95 95 95 
95 95 95 95 95 96 96 96 96 96 96 95 53 53 53 55 53 68 53 53 68 53 68 68 68 96 96 96 68 68 53 58 95 95 53 95 80 53 95 96 96 96 96 95 95 95 95 53 53 95 
95 95 95 95 95 95 96 96 96 96 96 95 68 73 87 68 68 68 53 68 73 55 53 68 68 96 96 96 68 95 95 95 95 95 53 95 54 95 58 96 96 96 96 96 95 95 53 95 95 95 
95 95 95 95 95 95 96 96 96 96 96 95 68 55 66 68 68 53 68 68 68 87 53 68 68 96 96 54 55 53 95 53 57 95 54 68 95 53 95 96 96 96 96 96 96 95 53 95 95 95 
95 95 55 95 95 95 96 96 96 96 96 68 53 53 58 68 68 68 68 68 68 68 68 68 96 96 96 68 58 95 66 53 68 95 95 57 95 68 54 96 96 96 96 96 96 53 53 95 95 95 
95 95 95 95 95 96 96 96 96 96 96 96 68 68 68 68 68 96 96 96 96 95 96 96 96 96 96 96 68 95 94 87 53 95 95 95 95 68 96 96 96 96 96 96 96 95 53 95 95 95 
95 95 95 95 95 96 96 96 96 96 96 96 96 96 96 96 96 96 96 96 96 95 95 96 96 96 96 96 96 68 95 55 68 57 95 95 54 96 96 96 96 96 96 96 96 53 56 95 95 95 
95 95 95 95 95 96 96 96 96 96 96 96 96 96 96 96 96 96 68 58 68 95 58 68 68 68 96 96 96 96 96 96 96 95 95 96 96 96 96 96 96 96 96 96 96 95 95 95 95 95 
95 95 95 95 95 96 96 96 96 96 96 96 96 87 95 95 68 68 95 95 55 80 59 95 68 96 96 96 96 96 96 96 96 95 96 96 96 96 96 96 96 96 96 96 96 96 95 95 95 95 
95 95 95 95 95 96 96 96 96 96 96 68 87 68 95 95 95 95 57 53 95 94 53 68 68 96 96 66 87 95 68 68 68 68 58 80 73 96 96 96 96 96 96 96 96 96 96 96 95 95 
95 55 95 53 96 96 96 96 96 96 96 95 58 95 95 57 95 53 55 95 56 53 95 68 96 96 96 94 53 68 68 53 95 68 68 68 53 94 96 96 96 96 96 96 96 96 96 96 96 95 
95 95 95 95 96 96 96 96 96 96 96 53 53 68 53 56 53 57 95 53 53 57 95 95 96 96 96 68 53 53 53 68 58 68 54 53 68 68 96 96 96 96 96 96 96 96 96 96 96 96 
55 95 95 55 96 96 96 96 96 96 96 55 58 95 95 95 95 54 87 66 95 55 68 95 96 96 96 68 68 68 68 53 68 54 53 95 53 96 96 96 96 96 96 96 96 96 96 96 96 96 
55 95 95 95 96 96 96 96 96 96 96 95 95 55 53 53 95 68 95 95 95 68 95 95 95 95 96 68 68 68 68 53 87 53 53 95 96 96 96 96 96 96 96 96 96 96 96 96 96 96 
95 95 95 95 96 96 96 96 96 96 96 56 53 95 95 95 95 53 95 95 95 95 68 68 96 95 95 68 55 53 53 55 80 94 95 96 96 96 96 96 96 96 96 96 96 96 96 96 32 32 
95 95 95 56 96 96 96 96 96 96 96 95 66 68 55 53 53 57 53 53 54 68 58 87 96 96 96 68 68 53 57 53 57 68 68 96 95 104 104 104 104 104 104 104 104 104 104 104 104 104 
95 95 95 55 96 96 96 96 96 96 96 55 94 87 95 53 53 56 95 53 53 53 87 96 96 96 96 80 57 95 53 53 54 95 95 53 102 101 101 101 101 101 101 101 101 101 101 101 101 101 
95 56 95 55 96 96 96 96 96 96 96 95 68 58 68 68 96 96 96 96 96 96 96 96 96 96 96 87 73 68 53 68 68 53 58 96 95 98 98 98 98 98 98 98 98 98 98 98 98 98 
95 95 95 55 95 95 95 96 96 96 96 96 96 96 96 96 96 96 96 96 96 96 96 68 80 96 96 96 96 94 68 68 68 53 56 68 96 96 96 96 96 96 96 96 96 96 96 96 32 32 
95 95 95 95 55 55 95 96 96 96 96 96 96 96 96 96 96 96 96 96 119 53 57 55 53 66 96 96 96 96 95 68 58 68 95 53 53 96 96 96 96 96 96 96 96 96 96 96 96 96 
95 95 95 55 56 95 96 96 96 96 96 96 96 96 80 94 59 68 53 68 68 53 54 95 53 95 94 68 68 96 96 96 96 96 53 68 53 80 96 96 96 96 96 96 96 96 96 96 96 96 
95 95 95 95 55 95 96 96 96 96 96 53 55 53 95 57 55 53 58 56 53 53 53 53 95 95 53 53 55 73 96 96 96 96 96 96 73 87 96 96 96 96 96 96 96 96 96 96 96 95 
95 95 95 55 95 96 96 96 96 96 96 73 53 53 95 55 53 95 53 53 53 95 95 58 53 53 95 53 53 80 87 96 96 96 96 96 96 96 96 96 96 96 96 96 96 96 96 95 95 95 
95 95 95 95 95 96 96 96 96 96 96 96 59 95 57 53 53 57 95 96 96 95 96 96 95 95 68 95 58 53 53 95 58 96 96 96 96 96 96 96 96 96 96 96 96 96 53 95 95 95 
95 95 95 95 95 96 96 96 96 96 96 96 96 96 87 95 56 95 96 96 96 95 96 96 96 95 95 95 57 95 95 53 55 106 96 96 96 96 96 96 96 96 96 96 53 53 53 53 95 95 
95 95 95 95 95 96 96 96 96 96 96 96 96 96 96 96 96 96 96 96 53 104 53 96 96 96 96 96 96 96 96 96 96 96 96 96 96 96 96 96 95 96 96 95 95 95 95 95 95 95 
95 95 95 95 95 95 95 95 95 96 96 96 96 96 96 96 96 96 96 96 102 101 100 96 96 96 96 96 96 96 96 96 96 96 96 96 96 96 95 95 95 96 53 95 95 53 53 95 95 95 
95 95 95 95 95 95 95 95 95 95 96 96 96 96 96 96 96 96 96 96 102 101 100 96 96 96 96 96 96 96 96 96 96 96 96 96 96 96 96 95 95 95 95 95 95 95 95 95 95 95 
95 95 95 95 95 95 95 95 95 95 95 95 96 96 96 96 96 96 96 96 102 101 100 96 96 96 96 96 96 96 96 96 96 96 96 95 95 95 95 95 95 95 95 53 95 95 95 95 95 95 
95 95 95 55 55 55 95 95 95 95 95 95 95 96 96 96 96 96 96 96 102 101 100 96 96 96 96 96 96 96 96 95 95 95 95 95 95 95 95 95 95 95 56 95 95 95 95 95 95 95 
95 95 95 95 95 55 95 95 95 95 95 95 95 95 96 96 96 96 96 96 102 101 100 96 96 96 96 96 96 95 95 95 95 95 95 95 95 95 95 95 95 56 56 95 54 95 95 95 95 95 
95 95 95 95 95 55 95 95 95 95 95 95 95 95 95 96 96 96 96 96 102 101 100 96 96 96 96 96 95 95 95 95 54 54 95 95 95 95 95 95 95 95 95 95 95 53 95 56 95 95 
95 95 95 95 95 95 95 95 95 95 95 55 55 96 96 96 96 96 96 96 102 101 100 96 96 96 96 96 96 95 54 95 95 95 95 95 95 53 95 95 95 53 95 95 95 95 95 56 95 95 
95 95 95 95 95 95 95 95 95 95 95 95 96 96 96 96 96 96 96 96 102 101 100 96 96 96 96 96 96 96 95 95 95 95 95 95 95 95 95 95 95 56 95 95 56 54 95 95 95 95 
