95 95 53 53 95 54 95 54 95 95 95 57 58 95 95 95 95 95 95 95 53 95 53 95 95 53 53 53 53 95 53 56 53 95 95 95 95 95 95 95 95 95 95 95 95 95 95 95 95 95 
95 95 54 95 53 95 54 54 95 95 95 58 58 95 95 95 53 53 95 95 95 95 95 53 95 95 57 95 95 95 95 95 95 95 53 95 53 58 56 95 95 95 95 95 95 95 95 95 95 95 
95 53 95 95 95 53 53 53 95 95 95 95 95 95 56 53 95 95 95 95 95 95 53 95 95 95 95 53 95 95 95 53 95 95 95 95 58 53 53 95 95 95 95 56 95 95 95 95 95 95 
57 53 95 95 57 57 95 95 95 95 95 95 95 95 95 56 95 53 53 53 56 95 53 57 95 58 58 95 58 53 58 95 95 56 95 95 53 58 53 95 53 53 95 56 53 95 95 53 95 95 
95 95 53 95 95 54 95 53 53 95 95 95 95 95 53 53 53 53 95 58 95 56 95 57 58 53 95 95 95 95 57 57 95 56 95 53 95 53 53 95 95 95 56 56 56 56 95 95 95 95 
53 95 95 53 54 53 55 95 53 95 95 95 95 56 95 53 53 95 53 95 53 95 53 53 95 95 95 95 95 95 95 95 53 53 53 95 58 95 56 95 95 56 53 56 95 56 95 95 95 95 
53 95 95 95 57 95 55 57 95 95 95 95 58 53 56 53 95 95 95 95 95 95 95 53 95 53 53 95 57 95 95 53 95 53 53 95 95 95 95 95 95 95 56 53 58 95 95 95 95 95 
95 95 57 57 95 54 53 95 95 32 32 32 32 32 32 32 32 32 32 32 32 32 32 32 32 32 32 32 32 32 32 32 32 32 32 32 32 32 32 32 32 56 95 53 95 53 95 95 95 95 
57 57 57 95 95 95 56 57 95 32 32 32 32 32 32 32 32 32 32 32 32 32 32 32 32 32 32 32 32 32 32 32 32 32 32 32 32 32 32 32 32 56 95 53 53 95 56 53 95 95 
95 95 95 95 95 55 56 95 95 32 32 114 108 108 108 108 108 115 53 54 54 95 54 95 95 95 53 54 53 54 54 54 54 54 53 53 54 95 53 32 32 95 95 95 95 53 95 95 95 95 
95 95 95 95 95 95 95 56 95 32 32 104 104 104 104 104 104 104 95 106 106 106 53 54 54 53 53 95 106 106 95 95 56 53 53 53 54 95 58 32 32 54 95 53 53 95 95 95 95 95 
95 95 95 56 95 95 95 95 95 32 32 101 101 101 101 101 101 101 100 55 53 53 56 54 95 95 95 54 53 95 53 53 106 106 95 95 95 54 53 32 32 54 54 54 56 53 95 54 95 95 
95 95 95 56 95 95 95 95 95 32 32 98 98 98 98 98 99 101 100 95 114 108 108 108 108 108 108 109 53 95 53 53 95 95 95 106 106 95 53 32 32 53 53 53 53 56 95 53 95 95 
95 95 95 95 95 55 95 95 95 32 32 114 108 108 109 95 102 101 103 104 104 104 104 104 106 106 95 112 106 106 95 95 54 53 95 54 95 95 95 32 32 56 95 53 53 53 95 53 95 95 
95 95 95 55 55 95 95 95 58 32 32 95 54 95 112 54 102 101 101 101 101 101 101 101 100 53 53 112 95 53 53 114 108 108 108 108 115 95 95 32 32 95 95 58 53 53 95 95 95 95 
95 95 95 95 95 95 55 55 95 32 32 95 54 54 117 54 53 98 98 98 98 98 99 101 103 95 53 117 95 95 95 95 53 54 95 54 53 95 54 32 32 95 95 53 95 53 95 95 95 95 
95 95 55 95 54 54 56 95 56 32 32 95 106 106 95 95 95 95 106 106 53 116 102 101 101 103 104 104 95 106 106 95 53 106 106 106 95 54 95 32 32 95 95 53 95 95 53 95 95 95 
95 95 95 55 54 95 95 55 95 32 32 95 56 54 95 95 114 108 108 108 108 113 95 99 101 101 101 101 100 95 53 54 95 95 116 53 54 114 115 32 32 95 95 95 56 95 95 53 53 95 
95 95 95 95 95 95 54 95 95 32 32 95 54 54 54 95 106 106 106 95 95 95 95 54 98 99 101 101 103 104 104 54 114 108 113 106 106 54 53 32 32 95 95 56 95 95 53 95 95 95 
95 95 95 95 95 95 54 55 95 32 32 53 54 95 95 95 95 95 54 95 54 106 106 53 95 102 101 101 101 101 101 103 104 104 104 104 104 104 104 32 32 95 95 95 95 95 53 95 95 95 
95 95 55 95 95 95 54 95 95 32 32 95 54 54 95 54 95 54 95 53 53 95 95 95 95 95 98 98 98 99 101 101 101 101 101 101 101 101 101 32 32 95 56 95 95 53 53 95 95 95 
95 95 55 95 95 95 95 95 95 32 32 53 54 106 106 95 95 95 95 56 54 95 95 106 106 53 53 54 53 54 98 98 98 98 98 98 98 98 98 32 32 95 56 56 53 95 53 95 95 95 
95 95 55 55 95 95 95 56 95 32 32 56 54 95 95 95 95 95 95 54 53 54 95 95 54 54 106 54 54 54 53 106 106 53 53 53 106 106 95 32 32 95 95 56 95 53 56 95 95 95 
95 95 95 95 95 95 95 95 95 32 32 55 54 95 54 95 54 106 106 54 53 95 53 53 95 95 95 54 53 53 53 53 53 54 95 53 54 54 95 32 32 95 95 95 95 95 95 95 95 95 
95 95 95 95 95 95 55 95 55 32 32 55 54 95 95 95 95 95 54 54 53 54 53 95 54 95 95 95 95 95 95 54 106 106 106 95 54 54 53 32 32 95 95 95 95 95 95 95 95 95 
95 95 95 95 95 95 95 95 95 32 32 95 54 54 54 54 54 54 95 95 95 56 53 53 56 95 95 53 54 95 95 54 95 95 95 53 106 106 95 32 32 95 95 95 95 95 95 95 95 95 
95 55 95 53 95 55 95 95 95 32 32 53 54 54 53 53 53 95 53 95 53 53 53 54 95 54 56 54 95 95 53 53 53 95 95 54 53 54 95 32 32 56 95 95 56 95 95 95 95 95 
95 95 95 95 95 95 55 55 55 32 32 95 54 53 54 53 53 95 53 95 95 53 54 54 95 95 95 95 54 53 53 95 95 53 54 95 53 54 56 32 32 95 95 95 53 95 95 95 95 95 
55 95 95 55 95 95 95 95 95 32 32 53 54 53 56 95 95 53 95 54 95 53 54 95 53 53 53 53 54 95 54 95 53 53 53 53 53 54 95 32 32 56 95 53 53 95 95 95 95 95 
55 95 95 95 95 95 95 95 95 32 32 53 54 95 95 95 95 56 53 53 56 53 53 95 54 53 53 53 53 95 95 53 54 53 95 95 54 54 95 32 32 95 95 95 95 95 95 95 95 95 
95 95 95 95 53 95 95 55 95 32 32 56 54 95 56 95 53 95 54 54 53 54 95 95 95 95 53 53 95 95 54 53 53 54 54 54 54 54 53 32 32 95 53 53 95 95 56 95 95 95 
95 95 95 56 53 53 95 95 55 32 32 95 54 54 95 95 95 53 95 53 95 54 95 54 95 95 95 54 95 54 53 53 53 54 95 54 95 95 53 32 32 95 53 95 53 56 95 95 95 95 
95 95 95 55 95 95 95 55 95 32 32 55 54 95 95 54 95 95 56 54 95 56 95 95 95 54 95 54 95 54 54 53 95 95 53 53 56 95 53 32 32 95 95 53 53 95 95 95 95 95 
95 56 95 55 95 95 95 95 95 32 32 55 54 95 56 54 54 95 95 53 54 56 54 53 95 54 54 54 95 95 54 54 95 54 54 53 53 54 53 32 32 95 95 95 56 95 95 95 95 95 
95 95 95 55 95 95 95 95 95 32 32 95 53 95 95 54 95 95 53 53 54 95 95 95 53 95 95 54 56 95 95 95 95 56 56 95 95 53 95 32 32 53 95 56 53 95 95 95 95 95 
95 95 95 95 55 55 95 55 95 32 32 53 53 53 54 95 95 95 54 95 54 54 53 54 95 95 95 56 54 53 95 95 53 95 95 95 53 53 53 32 32 95 95 95 53 95 95 95 95 95 
95 95 95 55 56 95 95 95 53 32 32 95 54 54 53 56 53 56 95 56 95 95 53 95 95 54 54 56 95 53 54 95 95 53 54 54 56 53 53 32 32 95 95 53 53 95 95 95 95 95 
95 95 95 95 55 95 55 95 95 32 32 55 54 54 53 53 95 53 95 95 95 56 53 56 53 95 53 53 53 53 95 53 53 95 95 95 95 54 95 32 32 53 53 95 54 54 95 95 95 95 
95 95 95 55 95 95 55 55 95 32 32 95 54 54 53 95 95 95 53 53 53 53 95 54 53 95 95 53 54 95 95 53 53 56 56 54 53 54 95 32 32 95 54 54 53 53 54 95 95 95 
95 95 95 95 95 55 95 95 95 32 32 95 54 54 53 53 53 53 53 53 54 54 53 53 53 56 95 95 95 54 54 54 95 54 53 53 54 54 54 32 32 54 53 54 95 95 53 95 95 95 
95 95 95 95 95 55 95 95 95 32 32 55 54 54 54 54 54 54 54 54 54 54 54 54 54 54 54 54 54 54 54 54 54 54 54 53 54 54 56 32 32 95 95 53 53 53 53 53 95 95 
95 95 95 95 95 55 95 95 55 32 32 32 32 32 32 32 32 32 32 32 32 32 32 32 32 32 32 32 32 32 32 32 32 32 32 32 32 32 32 32 32 95 95 95 95 95 95 95 95 95 
95 95 95 95 95 95 95 95 55 32 32 32 32 32 32 32 32 32 32 32 32 32 32 32 32 32 32 32 32 32 32 32 32 32 32 32 32 32 32 32 32 53 53 95 56 53 53 95 95 95 
95 95 95 95 95 95 95 95 95 95 95 55 95 55 95 95 55 95 53 53 53 95 95 95 95 95 55 95 53 95 95 56 53 95 95 95 95 95 54 95 95 95 95 56 95 95 95 95 95 95 
95 95 95 95 95 95 95 95 53 95 95 95 95 55 55 95 95 95 95 95 95 95 53 95 55 53 95 95 95 95 56 56 95 53 95 95 95 54 95 53 53 95 95 53 95 95 95 95 95 95 
95 95 95 55 55 55 95 95 55 95 95 55 95 95 95 55 95 95 95 53 53 95 95 53 55 95 54 55 54 54 56 95 53 95 95 54 53 95 95 95 53 95 56 95 95 95 95 95 95 95 
95 95 95 95 95 55 95 95 55 95 95 95 95 53 53 95 53 53 53 95 95 95 95 95 95 54 54 56 55 95 95 53 95 54 95 95 95 95 95 95 95 56 56 95 54 95 95 95 95 95 
95 95 95 95 95 55 95 95 95 95 95 95 95 55 95 55 95 95 95 95 95 95 95 95 95 95 95 95 95 95 95 54 54 54 95 95 95 95 95 95 95 95 95 95 95 53 95 56 95 95 
95 95 95 95 95 95 95 95 95 95 95 55 55 95 95 95 55 95 55 55 55 95 95 95 54 95 95 95 95 95 54 95 95 95 95 95 95 53 95 95 95 53 95 95 95 95 95 56 95 95 
95 95 95 95 95 95 95 95 95 95 95 95 95 95 95 95 95 95 95 95 95 95 95 95 95 95 95 95 95 95 95 95 95 95 95 95 95 95 95 95 95 56 95 95 56 54 95 95 95 95 
