95 95 53 53 95 54 95 54 95 96 96 57 58 95 95 95 95 95 95 95 53 95 53 95 95 53 53 53 53 95 53 56 53 95 95 95 95 95 95 96 96 95 95 95 95 95 95 95 95 95 
95 95 54 95 53 95 54 54 95 96 96 58 58 95 95 95 53 53 95 95 95 95 95 53 95 95 57 95 95 95 95 95 95 95 53 95 53 58 56 96 96 95 95 95 95 95 95 95 95 95 
95 53 95 95 95 53 53 53 95 96 67 95 95 95 56 53 95 95 95 95 95 95 53 95 95 95 95 53 95 95 95 53 95 95 95 95 58 53 53 96 96 95 95 56 95 95 95 95 95 95 
57 53 95 95 57 57 95 95 95 96 67 95 95 95 95 56 95 53 53 53 56 95 53 57 95 58 58 95 58 53 58 95 95 56 95 95 53 58 53 69 96 53 95 56 53 95 95 53 95 95 
95 95 53 95 95 54 95 53 53 96 67 95 95 95 53 53 53 53 95 58 95 56 95 57 58 53 95 95 95 95 57 57 95 56 95 53 95 53 53 69 96 96 56 56 56 56 95 95 95 95 
53 95 95 53 54 53 55 95 53 96 67 95 95 56 95 53 53 95 53 95 53 95 53 53 95 95 95 95 95 95 95 95 53 53 53 95 58 95 56 69 96 96 96 56 95 56 95 95 95 95 
53 95 95 95 57 95 55 57 95 96 67 95 58 53 56 53 95 95 95 95 95 95 95 53 95 53 53 95 95 95 95 53 95 53 53 95 95 95 95 69 96 96 96 53 58 95 95 95 95 95 
95 95 57 57 95 54 53 95 96 96 67 53 53 53 53 53 53 53 53 53 53 53 53 53 53 53 53 53 95 95 95 95 95 95 95 95 95 95 95 69 96 96 96 96 95 53 95 95 95 95 
57 57 57 95 53 53 56 57 96 96 74 75 75 75 75 75 75 75 75 75 75 75 75 75 75 75 75 75 75 75 75 75 75 75 75 75 75 75 75 76 96 96 96 96 53 95 56 53 95 95 
53 53 53 53 53 53 53 96 96 96 81 89 89 89 89 89 89 89 89 89 89 89 89 89 89 89 89 89 89 89 89 89 89 89 89 89 89 89 89 90 96 96 96 96 95 53 95 95 95 95 
95 95 95 53 53 96 96 96 96 96 94 56 56 95 53 96 95 96 96 53 95 95 95 95 95 95 53 53 53 95 95 95 96 96 96 95 53 56 58 95 96 96 96 96 96 95 95 95 95 95 
95 95 95 56 95 96 96 96 96 96 96 73 55 53 73 96 96 96 96 56 95 95 95 63 64 64 64 65 95 53 95 95 96 96 96 96 95 95 53 87 96 96 96 96 96 53 95 54 95 95 
95 95 95 56 96 96 96 96 96 96 96 58 87 53 53 53 96 96 96 95 95 53 95 70 71 71 71 72 95 95 95 58 96 96 96 96 58 58 58 96 96 96 96 96 96 56 95 53 95 95 
95 95 95 95 96 96 96 96 96 96 96 53 53 59 53 96 96 96 96 96 56 53 53 70 71 71 71 72 95 54 95 53 96 96 96 87 54 53 95 96 96 96 96 96 96 53 95 53 95 95 
95 95 95 55 96 96 96 96 96 96 96 95 56 95 95 53 96 96 96 96 96 95 95 77 78 78 78 79 53 95 95 96 96 96 95 53 58 58 95 96 96 96 96 96 53 53 95 95 95 95 
95 95 95 95 95 96 96 96 96 96 96 95 58 66 95 87 66 96 96 96 96 58 95 56 58 58 95 95 53 95 96 96 96 96 53 53 95 53 54 96 96 96 96 96 95 53 95 95 95 95 
95 95 55 95 54 54 56 96 96 96 96 95 95 95 95 95 53 95 96 96 96 96 96 95 95 95 55 96 96 96 96 96 96 96 53 95 95 95 95 96 96 96 96 96 96 95 53 95 95 95 
95 95 95 55 54 95 95 96 96 96 96 95 95 95 87 95 95 95 58 56 96 96 96 96 96 95 95 96 96 96 96 96 96 56 95 95 87 95 95 96 96 96 96 96 96 95 95 53 53 95 
95 95 95 95 95 95 96 96 96 96 96 73 59 95 95 95 95 56 58 95 96 96 96 96 96 95 96 96 96 96 96 96 96 54 87 54 95 95 95 96 96 96 96 96 96 96 53 95 95 95 
95 95 95 95 95 95 96 96 96 96 96 95 95 54 95 87 54 95 58 58 95 96 96 95 95 95 95 58 95 95 87 96 96 96 96 56 95 56 95 96 96 96 96 96 96 96 53 95 95 95 
95 95 55 95 95 96 96 96 96 96 96 95 95 95 95 53 95 95 95 87 95 96 96 96 95 95 95 56 55 95 95 95 96 96 95 95 95 95 95 96 96 96 96 96 96 96 53 95 95 95 
95 95 55 95 95 96 96 96 96 96 96 53 96 96 96 96 96 54 95 95 95 95 53 53 53 53 58 56 58 73 95 96 96 59 95 95 95 95 56 96 96 96 96 96 96 96 53 95 95 95 
95 95 55 55 95 96 96 96 96 96 96 96 96 96 96 96 96 96 95 95 95 95 95 96 96 95 95 95 95 95 96 96 96 95 95 95 95 95 87 96 96 96 96 96 96 96 56 95 95 95 
95 95 95 95 95 96 96 96 96 96 96 96 32 32 32 32 32 96 96 95 95 66 55 96 96 96 95 95 55 95 95 96 96 87 95 95 95 95 95 96 96 96 96 96 96 96 95 95 95 95 
95 95 95 95 96 96 96 96 96 96 96 96 32 71 71 71 32 32 68 95 95 73 95 95 96 96 96 58 66 95 96 96 96 95 56 95 56 95 95 96 96 96 96 96 96 96 95 95 95 95 
95 95 96 96 96 96 96 96 96 96 96 32 32 71 71 71 71 32 64 64 64 64 64 64 64 64 65 95 96 96 96 96 59 95 95 56 95 95 95 96 96 96 96 96 96 95 95 95 95 95 
95 55 96 96 96 96 96 96 96 96 96 32 71 71 71 71 71 71 71 71 71 71 71 71 71 71 72 53 96 96 95 73 95 95 54 95 54 56 95 96 96 96 96 96 56 95 95 95 95 95 
95 95 96 96 96 96 96 96 96 96 96 32 71 71 71 71 71 32 78 78 78 78 78 78 78 78 79 96 96 95 95 95 95 95 95 95 95 95 56 96 96 96 96 95 53 95 95 95 95 95 
55 95 96 96 96 96 96 96 96 96 96 32 71 71 71 71 71 32 68 68 95 95 95 95 95 56 96 96 96 95 56 95 66 56 53 56 54 95 95 96 96 96 96 96 53 95 95 95 95 95 
55 95 95 96 96 96 96 96 96 96 96 32 32 32 71 32 32 32 96 95 95 87 95 73 87 96 96 96 53 95 95 95 54 95 95 95 54 54 95 96 96 96 96 96 96 96 95 95 95 95 
95 95 95 95 96 96 96 96 96 96 96 32 71 71 71 32 96 96 96 96 54 59 54 95 96 96 96 87 95 54 95 95 95 54 95 95 95 95 95 96 96 96 96 96 96 96 56 95 95 95 
95 95 95 56 53 96 96 96 96 96 96 32 32 32 32 32 96 96 96 95 95 95 95 53 95 56 56 73 54 95 95 56 95 54 53 54 95 95 95 96 96 96 96 96 96 96 95 95 95 95 
95 95 95 55 95 95 96 96 96 96 96 96 96 96 96 96 96 53 56 95 95 95 55 66 95 56 95 95 95 95 87 95 95 53 95 54 95 95 95 96 96 96 96 96 96 95 95 95 95 95 
95 56 95 55 95 95 96 96 96 96 96 55 96 96 87 53 95 95 56 95 95 95 95 95 95 95 59 56 95 54 87 95 53 95 54 95 54 95 95 96 96 96 96 96 96 95 95 95 95 95 
95 95 95 55 95 96 96 96 96 96 96 95 95 95 95 95 95 95 95 95 95 95 53 53 95 95 95 95 95 54 95 54 95 54 53 95 54 95 95 96 96 96 96 96 96 96 95 95 95 95 
95 95 95 95 55 96 96 96 96 96 96 53 87 95 55 95 56 95 95 95 95 95 95 55 55 95 95 95 54 95 54 54 95 54 95 54 54 95 95 96 96 96 96 96 53 95 95 95 95 95 
95 95 95 55 96 96 96 96 96 96 96 95 55 53 55 55 53 53 95 53 95 95 55 95 55 95 95 53 56 56 95 95 95 54 95 95 95 53 95 96 96 96 96 96 53 95 95 95 95 95 
95 95 95 95 96 96 96 96 96 96 96 55 95 53 55 95 95 53 87 95 95 53 95 95 95 95 95 56 53 95 54 53 53 53 95 95 53 53 95 96 96 96 96 96 96 54 95 95 95 95 
95 95 95 96 96 96 96 96 96 96 96 94 55 87 53 55 95 95 53 95 53 95 53 95 95 95 95 95 95 95 53 53 55 95 95 53 95 95 95 96 96 96 96 96 96 53 54 95 95 95 
95 95 95 96 96 96 96 96 96 96 96 87 95 95 95 95 55 95 95 53 95 95 95 95 95 95 95 95 53 95 54 95 95 95 95 95 53 95 54 96 96 96 96 96 96 96 53 95 95 95 
95 95 95 96 96 96 96 96 96 96 96 55 56 55 95 95 95 95 95 55 95 95 95 95 95 95 95 95 55 95 54 95 95 95 95 56 54 95 95 96 96 96 96 96 96 96 96 53 95 95 
95 95 95 96 96 96 96 96 96 96 96 96 96 96 96 96 96 96 96 96 96 96 96 96 96 96 96 96 96 96 96 96 96 96 96 96 96 96 96 96 96 96 96 96 96 96 96 95 95 95 
95 95 95 95 96 96 96 96 96 96 96 96 96 96 96 96 96 96 96 96 96 96 96 96 96 96 96 96 96 96 96 96 96 96 96 96 96 96 96 96 96 96 96 96 96 96 96 95 95 95 
95 95 95 95 95 96 96 96 96 96 96 96 96 96 96 96 96 96 96 96 96 96 96 96 96 96 96 96 96 96 96 96 96 96 96 96 96 96 96 96 96 96 96 96 96 96 95 95 95 95 
95 95 95 95 95 95 96 96 96 96 96 96 96 96 96 96 96 96 96 96 96 96 96 96 96 96 96 96 96 96 96 96 96 96 96 96 96 96 96 96 96 96 96 96 96 95 95 95 95 95 
95 95 95 55 55 55 96 96 96 96 96 96 96 96 96 96 96 96 96 96 96 96 96 96 96 96 96 96 96 96 96 96 96 96 96 96 96 96 96 96 96 96 96 96 96 95 95 95 95 95 
95 95 95 95 95 55 95 95 55 95 95 95 95 53 53 96 96 96 96 96 96 96 96 95 95 54 96 96 96 96 96 96 96 96 95 95 95 96 96 96 96 96 56 95 54 95 95 95 95 95 
95 95 95 95 95 55 95 95 95 95 95 95 95 55 95 55 95 96 96 96 96 96 95 95 95 95 96 96 96 96 96 96 54 54 95 95 95 95 95 95 95 95 95 95 95 53 95 56 95 95 
95 95 95 95 95 95 95 95 95 95 95 55 55 95 95 95 55 95 96 96 96 96 95 95 54 95 95 96 96 96 96 95 95 95 95 95 95 53 95 95 95 53 95 95 95 95 95 56 95 95 
95 95 95 95 95 95 95 95 95 95 95 95 95 95 95 95 95 95 95 95 95 95 95 95 95 95 95 95 95 95 95 95 95 95 95 95 95 95 95 95 95 56 95 95 56 54 95 95 95 95 
