95 95 53 53 95 54 95 54 95 95 95 57 58 95 95 95 95 95 95 95 53 95 53 95 95 53 53 53 53 95 53 56 53 95 95 95 95 95 95 95 95 95 95 95 95 95 95 95 95 95 
95 95 54 95 53 95 54 54 95 95 95 58 58 95 95 95 53 53 95 95 95 95 95 53 95 95 57 95 95 95 95 95 95 95 53 95 53 58 56 95 95 95 95 95 95 95 95 95 95 95 
95 53 95 95 95 53 53 53 95 95 95 95 95 95 56 53 95 95 95 95 95 95 53 95 95 95 95 53 95 95 95 53 95 95 95 95 58 53 53 95 95 95 95 56 95 95 95 95 95 95 
57 53 95 95 57 57 95 95 95 95 95 95 95 95 95 56 95 53 53 53 56 95 53 57 95 58 58 95 58 53 58 95 95 56 95 95 53 58 53 95 53 53 95 56 53 95 95 53 95 95 
95 95 53 95 95 54 95 53 53 95 95 95 95 95 53 53 53 53 95 58 95 56 95 57 58 53 95 95 95 95 57 57 95 56 95 53 95 53 53 95 95 95 56 56 56 56 95 95 95 95 
53 95 95 53 54 53 55 95 53 95 95 95 95 56 95 53 53 95 53 95 53 95 53 53 95 95 95 95 95 95 95 95 53 53 53 95 58 95 56 95 95 56 53 56 95 56 95 95 95 95 
53 95 95 95 57 95 55 57 95 95 95 95 58 53 56 53 95 95 95 95 95 95 95 53 95 53 53 95 57 95 95 53 95 53 53 95 95 95 95 95 95 95 56 53 58 95 95 95 95 95 
95 95 57 57 95 54 53 95 95 32 32 32 32 32 32 32 32 32 32 32 32 32 32 32 32 32 32 32 32 32 32 32 32 32 32 32 32 32 32 32 32 56 95 53 95 53 95 95 95 95 
57 57 57 95 95 95 56 57 95 32 32 32 32 32 32 32 32 32 32 32 32 32 32 32 32 32 32 32 32 32 32 32 32 32 32 32 32 32 32 32 32 56 95 53 53 95 56 53 95 95 
95 95 95 95 95 55 56 95 95 32 32 55 55 53 95 95 53 95 53 56 95 95 95 53 95 53 95 95 95 53 58 95 54 53 95 53 95 53 53 32 32 95 95 95 95 53 95 95 95 95 
95 95 95 95 95 95 95 56 95 32 32 56 56 95 53 53 95 95 95 53 95 95 95 53 95 95 53 53 53 95 95 95 56 53 95 95 53 56 58 32 32 54 95 53 53 95 95 95 95 95 
95 95 95 56 95 95 95 95 95 32 32 56 56 95 95 95 57 95 57 56 95 95 95 53 53 95 53 54 95 53 95 95 56 58 95 95 95 53 53 32 32 54 54 54 56 53 95 54 95 95 
95 95 95 56 95 95 95 95 95 32 32 55 95 95 53 53 58 95 95 95 95 53 95 95 95 53 95 53 95 95 95 58 53 56 95 95 58 58 58 32 32 53 53 53 53 56 95 53 95 95 
95 95 95 95 95 55 95 95 95 32 32 95 95 95 95 95 95 56 95 95 56 53 53 58 53 95 53 95 95 95 95 53 58 53 56 95 54 53 95 32 32 56 95 53 53 53 95 53 95 95 
95 95 95 55 55 95 95 95 58 32 32 95 56 95 95 58 58 95 95 53 95 58 53 95 58 58 58 58 53 58 95 54 95 95 95 53 58 58 95 32 32 95 95 58 53 53 95 95 95 95 
95 95 95 95 95 95 55 55 95 32 32 95 58 58 95 53 56 58 95 58 58 58 56 56 58 58 95 95 53 95 53 58 54 95 53 53 95 53 54 32 32 95 95 53 95 53 95 95 95 95 
95 95 55 95 54 54 56 95 56 32 32 95 95 95 95 95 53 95 53 95 53 53 95 95 95 95 95 95 53 95 54 56 95 95 53 95 95 95 95 32 32 95 95 53 95 95 53 95 95 95 
95 95 95 55 54 95 95 55 95 32 32 95 95 95 95 95 95 95 58 56 56 56 95 53 95 95 95 95 95 95 95 95 53 56 95 95 95 95 95 32 32 95 95 95 56 95 95 53 53 95 
95 95 95 95 95 95 54 95 95 32 32 95 95 95 95 95 95 56 56 95 95 95 95 95 95 95 95 95 95 95 95 95 95 54 56 54 95 95 95 32 32 95 95 56 95 95 53 95 95 95 
95 95 95 95 95 95 54 55 95 32 32 95 95 54 95 54 54 95 95 95 95 95 56 95 95 95 95 56 95 95 95 95 95 54 56 56 95 56 95 32 32 95 95 95 95 95 53 95 95 95 
95 95 55 95 95 95 54 95 95 32 32 95 95 95 95 53 95 95 95 95 95 95 95 95 95 95 95 56 95 95 95 95 95 56 95 95 95 95 95 32 32 95 56 95 95 53 53 95 95 95 
95 95 55 95 95 95 95 95 95 32 32 53 95 53 53 95 95 54 95 95 95 56 95 95 95 56 56 56 56 95 95 56 95 56 95 95 95 95 56 32 32 95 56 56 53 95 53 95 95 95 
95 95 55 55 95 95 95 56 95 32 32 56 95 55 55 95 95 53 95 95 95 56 95 95 95 95 95 95 95 95 95 95 95 95 95 95 95 95 95 32 32 95 95 56 95 53 56 95 95 95 
95 95 95 95 95 95 95 95 95 32 32 55 95 95 95 55 55 95 95 95 95 56 95 95 95 56 95 95 95 95 95 56 95 95 95 95 95 95 95 32 32 95 95 95 95 95 95 95 95 95 
95 95 95 95 95 95 55 95 55 32 32 55 55 56 56 95 95 95 95 95 95 95 95 95 95 95 95 56 95 95 95 56 95 95 56 95 56 95 95 32 32 95 95 95 95 95 95 95 95 95 
95 95 95 95 95 95 95 95 95 32 32 95 95 95 95 54 95 95 56 95 95 95 95 95 56 95 95 95 95 95 95 95 95 95 95 56 95 95 95 32 32 95 95 95 95 95 95 95 95 95 
95 55 95 53 95 55 95 95 95 32 32 95 55 95 95 95 53 95 95 95 95 95 95 54 54 54 54 54 95 95 95 95 95 95 54 95 54 56 95 32 32 56 95 95 56 95 95 95 95 95 
95 95 95 95 95 95 55 55 55 32 32 95 95 55 95 53 53 53 95 95 95 95 95 95 54 95 95 54 95 95 95 95 95 95 95 95 95 95 56 32 32 95 95 95 53 95 95 95 95 95 
55 95 95 55 95 95 95 95 95 32 32 55 95 55 55 95 95 95 95 95 95 95 95 95 95 56 95 54 95 95 56 95 95 56 53 56 54 95 95 32 32 56 95 53 53 95 95 95 95 95 
55 95 95 95 95 95 95 95 95 32 32 53 95 55 95 95 95 56 54 95 95 95 95 95 95 95 54 54 53 95 95 95 54 95 95 95 54 54 95 32 32 95 95 95 95 95 95 95 95 95 
95 95 95 95 53 95 95 55 95 32 32 56 95 95 95 95 95 95 95 95 54 95 54 95 54 95 95 95 95 54 95 95 95 54 95 95 95 95 95 32 32 95 53 53 95 95 56 95 95 95 
95 95 95 56 53 53 95 95 55 32 32 95 95 95 95 95 95 95 95 95 95 95 95 53 95 56 56 95 54 95 95 56 95 54 53 54 95 95 95 32 32 95 53 95 53 56 95 95 95 95 
95 95 95 55 95 95 95 55 95 32 32 55 95 56 95 95 95 53 56 95 95 95 55 95 95 56 95 95 95 95 95 95 95 53 95 54 95 95 95 32 32 95 95 53 53 95 95 95 95 95 
95 56 95 55 95 95 95 95 95 32 32 55 53 95 53 53 95 95 56 95 95 95 95 95 95 95 56 56 95 54 95 95 53 95 54 95 54 95 95 32 32 95 95 95 56 95 95 95 95 95 
95 95 95 55 95 95 95 95 95 32 32 95 95 95 95 95 95 95 95 95 95 95 53 53 95 95 95 95 95 54 95 54 95 54 53 95 54 95 95 32 32 53 95 56 53 95 95 95 95 95 
95 95 95 95 55 55 95 55 95 32 32 53 95 95 55 95 56 95 95 95 95 95 95 55 55 95 95 95 54 95 54 54 95 54 95 54 54 95 95 32 32 95 95 95 53 95 95 95 95 95 
95 95 95 55 56 95 95 95 53 32 32 95 55 53 55 55 53 53 95 53 95 95 55 95 55 95 95 53 56 56 95 95 95 54 95 95 95 53 95 32 32 95 95 53 53 95 95 95 95 95 
95 95 95 95 55 95 55 95 95 32 32 55 95 53 55 95 95 53 95 95 95 53 95 95 95 95 95 56 53 95 54 53 53 53 95 95 53 53 95 32 32 53 53 95 54 54 95 95 95 95 
95 95 95 55 95 95 55 55 95 32 32 95 55 95 53 55 95 95 53 95 53 95 53 95 95 95 95 95 95 95 53 53 55 95 95 53 95 95 95 32 32 95 54 54 53 53 54 95 95 95 
95 95 95 95 95 55 95 95 95 32 32 95 95 95 95 95 55 95 95 53 95 95 95 95 95 95 95 95 53 95 54 95 95 95 95 95 53 95 54 32 32 54 53 54 95 95 53 95 95 95 
95 95 95 95 95 55 95 95 95 32 32 55 56 55 95 95 95 95 95 55 95 95 95 95 95 95 95 95 55 95 54 95 95 95 95 56 54 95 56 32 32 95 95 53 53 53 53 53 95 95 
95 95 95 95 95 55 95 95 55 32 32 32 32 32 32 32 32 32 32 32 32 32 32 32 32 32 32 32 32 32 32 32 32 32 32 32 32 32 32 32 32 95 95 95 95 95 95 95 95 95 
95 95 95 95 95 95 95 95 55 32 32 32 32 32 32 32 32 32 32 32 32 32 32 32 32 32 32 32 32 32 32 32 32 32 32 32 32 32 32 32 32 53 53 95 56 53 53 95 95 95 
95 95 95 95 95 95 95 95 95 95 95 55 95 55 95 95 55 95 53 53 53 95 95 95 95 95 55 95 53 95 95 56 53 95 95 95 95 95 54 95 95 95 95 56 95 95 95 95 95 95 
95 95 95 95 95 95 95 95 53 95 95 95 95 55 55 95 95 95 95 95 95 95 53 95 55 53 95 95 95 95 56 56 95 53 95 95 95 54 95 53 53 95 95 53 95 95 95 95 95 95 
95 95 95 55 55 55 95 95 55 95 95 55 95 95 95 55 95 95 95 53 53 95 95 53 55 95 54 55 54 54 56 95 53 95 95 54 53 95 95 95 53 95 56 95 95 95 95 95 95 95 
95 95 95 95 95 55 95 95 55 95 95 95 95 53 53 95 53 53 53 95 95 95 95 95 95 54 54 56 55 95 95 53 95 54 95 95 95 95 95 95 95 56 56 95 54 95 95 95 95 95 
95 95 95 95 95 55 95 95 95 95 95 95 95 55 95 55 95 95 95 95 95 95 95 95 95 95 95 95 95 95 95 54 54 54 95 95 95 95 95 95 95 95 95 95 95 53 95 56 95 95 
95 95 95 95 95 95 95 95 95 95 95 55 55 95 95 95 55 95 55 55 55 95 95 95 54 95 95 95 95 95 54 95 95 95 95 95 95 53 95 95 95 53 95 95 95 95 95 56 95 95 
95 95 95 95 95 95 95 95 95 95 95 95 95 95 95 95 95 95 95 95 95 95 95 95 95 95 95 95 95 95 95 95 95 95 95 95 95 95 95 95 95 56 95 95 56 54 95 95 95 95 
