16 1 16 1 1 16 1 1 16 1 16 1 16 1 1 16 1 1 16 1 1 16 16 16 1 1 1 16 1 1 1 16 16 1 1 1 16 16 16 16 16 1 1 16 1 16 1 1 1 1 
10 10 10 10 10 10 10 10 1 1 16 1 1 1 1 1 16 1 16 16 16 1 1 1 1 10 10 10 10 10 1 1 16 16 16 16 16 1 16 1 1 1 1 16 16 1 1 1 1 1 
3 3 3 3 3 3 3 3 9 10 10 10 10 10 10 10 10 10 10 10 10 10 10 10 11 3 3 3 3 3 9 10 10 10 10 1 1 16 1 16 16 16 16 1 1 1 1 16 16 1 
3 3 3 3 3 3 3 3 3 3 3 3 3 3 3 3 3 3 3 3 3 3 3 3 3 3 3 3 3 3 3 3 3 3 3 9 10 10 10 10 10 1 1 1 16 16 1 1 1 16 
5 5 5 16 5 5 5 5 6 3 3 3 3 3 3 3 3 3 3 3 3 3 3 3 3 3 4 5 6 3 3 3 3 3 3 3 3 3 3 3 3 9 1 1 16 16 1 1 1 1 
16 1 16 1 1 1 1 16 1 5 5 5 5 5 5 5 5 5 5 5 5 5 5 6 3 3 7 1 1 6 3 3 3 3 3 3 3 3 3 3 3 3 3 9 1 1 1 16 1 16 
1 1 1 16 16 1 1 16 1 16 16 1 1 1 1 16 1 1 1 16 1 1 1 8 3 3 7 1 1 1 5 5 5 5 5 5 5 5 5 5 5 6 3 3 9 10 10 10 10 10 
17 1 1 1 1 16 1 16 16 1 1 1 1 1 16 1 1 1 1 1 1 1 16 8 3 3 7 16 1 1 1 1 16 1 1 1 1 1 1 1 1 8 3 3 3 3 3 3 3 3 
17 1 1 1 1 1 1 1 16 1 1 1 1 1 1 1 1 1 1 1 1 16 1 8 3 3 7 1 1 1 1 1 1 1 1 1 1 16 1 1 1 1 6 3 3 3 3 3 3 3 
17 1 1 17 17 17 17 1 1 1 1 16 1 16 1 1 1 1 1 1 1 1 1 8 3 3 7 1 1 16 1 1 1 1 1 1 1 16 1 1 1 1 8 3 3 3 3 3 3 3 
17 17 17 17 1 1 17 17 1 1 1 1 1 16 16 1 1 1 16 16 1 16 1 8 3 3 7 1 1 1 1 1 1 1 17 17 1 17 1 1 1 1 17 5 5 5 5 5 5 5 
17 1 1 1 1 1 1 1 1 1 1 1 1 1 1 1 1 1 1 1 1 1 1 8 3 3 7 1 1 1 1 1 1 1 1 17 1 1 17 1 16 17 1 16 1 1 1 1 1 1 
17 1 1 1 20 21 21 21 21 21 21 21 21 21 21 21 22 1 1 1 1 1 16 8 3 3 7 1 1 1 1 1 17 17 17 17 17 17 17 17 17 17 17 17 17 17 16 1 1 16 
17 1 1 2 23 18 18 18 18 18 18 18 18 18 18 19 24 2 17 1 1 1 16 8 3 3 7 1 1 16 1 1 1 1 17 17 3 3 3 3 3 3 3 17 17 17 17 17 1 1 
1 1 1 2 23 18 19 18 18 18 18 18 18 18 18 19 24 2 17 2 2 1 16 8 3 3 7 1 16 1 1 1 1 1 1 17 17 3 3 3 3 3 3 3 3 3 17 17 1 1 
1 1 2 2 23 19 18 18 18 18 18 18 18 18 19 18 24 1 17 17 1 1 1 8 3 3 7 1 1 1 1 16 1 1 1 17 17 17 17 17 3 3 3 3 3 3 17 17 1 1 
1 1 2 2 23 18 18 19 18 18 18 18 18 18 19 18 24 1 1 17 2 1 1 8 3 3 7 1 1 1 1 16 1 16 1 17 3 3 17 3 3 17 3 3 17 3 3 3 1 1 
1 1 17 2 25 26 26 26 26 26 26 26 26 26 26 26 27 14 15 17 2 1 16 8 3 3 7 1 16 1 1 1 1 1 17 3 3 17 17 3 17 17 3 3 3 17 17 17 1 1 
1 1 17 2 1 1 1 1 1 1 1 1 1 1 1 1 16 2 2 2 1 1 2 8 3 3 7 1 1 1 1 16 1 1 17 3 3 3 3 3 3 3 3 3 3 17 17 17 1 1 
1 1 17 1 17 17 17 17 17 1 1 1 1 1 1 1 1 1 1 16 16 1 16 8 3 3 7 1 1 1 1 16 16 1 17 17 3 3 3 17 3 3 3 3 17 17 1 1 1 1 
1 1 1 17 17 17 17 17 1 17 1 1 1 17 17 17 17 1 1 1 1 1 1 8 3 3 7 1 1 1 1 1 1 1 17 17 17 17 17 17 17 17 17 17 17 1 1 1 1 1 
1 1 1 1 1 1 1 1 1 1 1 1 1 1 1 1 1 1 1 1 16 1 1 8 3 3 7 1 1 16 1 1 1 1 1 1 1 1 1 1 1 1 1 1 1 1 16 1 1 1 
1 1 16 1 1 1 1 1 1 1 16 16 1 1 1 1 16 1 1 16 1 1 1 11 3 3 7 1 16 1 1 1 1 1 1 16 16 1 17 17 17 1 1 1 17 1 1 1 1 1 
1 1 1 1 1 1 1 1 16 1 1 1 1 1 1 1 10 10 10 10 10 10 11 3 3 3 7 1 16 1 16 1 1 1 1 16 16 1 16 1 17 1 1 16 1 17 1 17 1 1 
1 16 1 16 1 1 16 1 16 1 1 1 10 10 10 11 3 3 3 3 3 3 3 3 3 3 9 10 10 1 16 1 1 1 1 1 1 1 16 1 1 16 1 1 1 16 1 1 1 1 
1 16 1 1 1 1 1 1 1 10 10 11 3 3 3 3 3 3 3 3 3 3 3 3 3 3 3 3 3 9 10 10 10 10 10 10 10 10 10 10 10 10 10 10 1 1 1 16 16 1 
16 16 1 1 1 10 10 10 11 3 3 3 3 3 3 3 4 5 5 5 5 5 6 3 3 4 5 6 3 3 3 3 3 3 3 3 3 3 3 3 3 3 3 3 9 10 10 10 10 10 
1 1 1 10 11 3 3 3 3 3 3 3 3 4 5 5 16 1 1 1 1 1 8 3 3 7 16 8 3 3 3 3 3 3 3 3 3 3 3 3 3 3 3 3 3 3 3 3 3 3 
10 10 11 3 3 3 3 3 3 3 3 3 3 7 1 16 1 1 16 1 16 1 8 3 3 7 1 2 5 5 5 5 5 5 5 5 5 5 5 5 5 5 5 6 3 3 3 3 3 3 
3 3 3 3 3 3 4 5 5 5 5 5 5 1 1 1 1 1 1 1 1 1 8 3 3 7 16 1 16 1 16 16 1 1 1 16 1 1 16 1 1 16 1 1 5 5 5 5 5 5 
3 3 3 3 3 3 7 1 1 1 1 1 16 1 1 1 1 1 1 1 1 1 8 3 3 7 1 1 1 1 1 1 1 1 16 1 1 1 17 17 17 17 17 2 2 2 2 2 1 1 
3 3 3 3 3 4 1 1 1 16 1 1 1 1 1 1 16 1 16 1 1 16 8 3 3 7 1 1 1 1 1 1 16 16 1 1 1 17 17 17 17 17 17 17 17 17 17 2 1 1 
5 16 5 5 5 1 1 1 1 1 1 1 1 1 1 1 1 1 1 1 1 1 8 3 3 7 1 16 1 1 16 1 1 1 1 1 1 16 1 1 1 17 17 17 17 17 17 17 17 1 
16 1 16 1 1 1 1 1 1 1 1 1 1 1 1 1 1 1 1 16 1 1 8 3 3 7 1 1 1 1 1 1 16 1 1 1 1 1 1 1 1 1 1 1 1 1 17 17 17 17 
1 1 1 1 1 16 16 1 1 1 1 1 1 1 1 1 1 1 1 1 16 1 8 3 3 7 1 16 1 1 1 1 16 16 1 1 16 1 1 1 1 1 1 16 16 1 1 1 1 1 
32 32 32 32 32 32 32 32 32 32 32 32 32 32 32 32 1 1 1 16 1 1 8 3 3 9 1 1 1 1 1 1 1 1 16 1 1 1 1 1 1 16 1 1 1 1 1 1 1 1 
32 34 34 34 34 34 34 34 34 34 34 34 34 34 35 32 1 1 1 1 10 10 11 3 3 3 7 1 1 1 10 10 1 1 1 1 1 1 1 1 1 16 1 1 1 1 16 1 1 1 
32 34 34 34 34 34 34 34 34 34 34 34 34 34 35 32 1 1 1 11 3 3 3 3 3 3 9 1 1 8 32 32 32 32 32 32 32 32 32 32 32 32 32 32 7 1 1 1 1 1 
32 34 34 35 34 34 34 34 34 34 34 34 34 34 34 32 10 10 11 3 4 5 5 5 6 3 3 9 10 8 32 34 34 34 34 34 34 34 35 35 34 34 34 32 7 1 1 1 1 16 
32 34 34 35 34 34 34 34 34 34 34 34 34 34 34 34 3 3 3 4 16 1 16 1 1 6 3 3 3 3 34 34 34 34 34 34 34 34 34 34 34 34 34 32 7 1 1 1 16 16 
32 34 34 34 34 34 34 34 34 34 34 34 34 34 34 32 4 5 5 1 1 1 1 1 1 1 5 5 5 6 32 34 34 34 34 34 34 34 34 34 34 34 34 32 7 1 1 16 1 1 
32 34 34 34 34 34 34 34 34 34 34 34 34 34 34 32 7 2 1 1 16 17 17 1 1 16 16 1 1 8 32 34 34 34 34 34 34 34 34 34 34 34 34 32 7 16 16 1 1 1 
32 34 34 34 34 34 34 34 34 34 35 35 35 34 34 32 7 2 1 1 1 17 17 17 1 1 1 16 1 8 32 34 34 34 34 34 34 34 34 34 34 34 35 32 7 1 1 16 16 1 
32 32 32 32 32 32 32 32 32 32 32 32 32 32 32 32 7 17 1 17 17 17 1 17 1 1 1 1 2 8 32 34 34 34 34 34 34 34 34 34 34 34 35 32 7 1 1 1 1 1 
1 1 1 1 1 1 1 1 5 5 5 5 5 5 5 5 2 17 1 1 17 1 1 17 17 1 1 1 2 8 32 34 34 34 34 34 34 34 34 34 34 34 34 32 7 1 17 17 1 1 
1 1 1 1 1 1 1 1 1 1 1 1 16 1 16 2 17 17 17 1 1 1 1 17 17 1 1 1 2 8 32 34 34 35 35 34 34 34 34 34 34 34 34 32 7 1 17 17 1 17 
1 1 1 1 1 1 17 1 1 1 1 1 1 1 16 1 1 1 1 1 1 16 1 17 1 1 16 1 2 8 32 34 34 34 34 34 34 34 34 34 34 34 34 32 7 1 1 17 17 17 
1 1 1 1 1 1 1 17 17 1 1 1 1 17 17 1 1 17 1 1 16 1 1 16 1 1 1 1 2 8 32 32 32 32 32 32 32 32 32 32 32 32 32 32 7 1 1 1 17 17 
1 1 1 1 1 1 17 17 17 17 17 17 17 1 1 17 17 17 1 16 1 1 1 1 17 17 17 17 2 2 5 5 5 5 5 5 5 5 5 5 5 5 5 5 1 1 1 1 17 17 
1 1 1 1 1 1 1 17 1 1 1 1 1 17 1 1 1 1 1 1 16 1 1 1 1 17 17 17 1 16 1 16 1 1 16 16 1 1 1 1 1 1 1 1 1 1 1 1 17 17 
