18 18 18 18 18 18 18 18 18 18 18 18 18 18 18 18 18 18 18 18 18 18 18 18 18 18 18 18 18 18 18 18 18 18 18 18 18 18 18 18 18 18 18 18 18 18 18 18 18 18 
18 18 18 18 18 18 18 18 18 18 18 18 18 18 18 18 18 18 18 18 18 18 18 18 18 18 18 18 18 18 18 18 18 18 18 18 18 18 18 18 18 18 18 18 18 18 18 18 18 18 
18 18 18 18 18 18 18 18 18 18 18 18 18 18 18 18 18 18 18 18 18 18 18 18 18 18 18 18 18 18 18 18 18 18 18 18 18 18 18 18 18 18 18 18 18 18 18 18 18 18 
18 18 18 18 18 18 18 18 18 18 18 18 18 18 18 18 18 18 18 18 18 18 18 18 18 18 18 18 18 18 18 18 18 18 18 18 18 18 18 18 18 18 18 18 18 18 18 18 18 18 
18 18 18 18 18 18 18 18 18 18 18 18 18 18 18 18 18 18 18 18 18 18 18 18 18 18 18 18 18 18 18 18 18 18 18 18 18 18 18 18 18 18 18 18 18 18 18 18 18 18 
18 18 18 18 18 18 18 18 18 18 18 18 18 18 18 18 18 18 18 18 18 18 18 18 18 18 18 18 18 18 18 18 18 18 18 18 18 18 18 18 18 18 18 18 18 18 18 18 18 18 
18 18 18 18 18 18 18 18 18 18 18 18 18 18 18 18 18 18 18 18 18 18 18 18 18 18 18 18 18 18 18 18 18 18 18 18 18 18 18 18 18 18 18 18 18 18 18 18 18 18 
18 18 18 18 18 18 18 18 18 18 18 28 26 26 26 26 26 26 26 26 26 26 26 26 26 26 26 26 26 26 26 26 26 26 26 26 26 26 29 18 18 18 18 18 18 18 18 18 18 18 
18 18 18 18 18 18 18 18 18 18 18 24 16 16 16 16 16 16 1 1 1 1 1 16 16 1 1 1 1 1 1 1 1 1 1 39 1 1 23 18 18 18 18 18 18 18 18 18 18 18 
18 18 18 18 18 18 18 18 18 18 18 24 16 16 16 16 1 2 1 1 39 1 1 1 16 16 16 1 1 1 38 1 2 2 1 1 38 1 23 18 18 18 18 18 18 18 18 18 18 18 
18 18 18 18 18 18 18 18 18 18 18 24 16 16 2 1 1 1 2 1 1 1 39 1 1 16 16 16 1 39 1 43 50 50 50 44 1 1 23 18 18 18 18 18 18 18 18 18 18 18 
18 18 18 18 18 18 18 18 18 18 18 24 16 16 1 1 2 2 1 1 1 38 1 1 1 16 16 16 1 1 1 46 33 33 33 47 2 1 23 18 18 18 18 18 18 18 18 18 18 18 
18 18 18 18 18 18 18 18 18 18 18 24 16 1 1 1 1 1 2 1 1 1 1 1 39 1 16 16 1 2 1 46 33 33 33 47 1 39 23 18 18 18 18 18 18 18 18 18 18 18 
18 18 18 18 18 18 18 18 18 18 18 24 1 1 1 1 1 2 2 2 2 1 1 38 1 1 16 16 1 1 2 46 33 33 33 47 2 1 23 18 18 18 18 18 18 18 18 18 18 18 
18 18 18 18 18 18 18 18 18 18 18 24 1 39 1 1 2 1 1 1 1 2 2 1 1 16 16 1 38 1 1 49 41 1 40 51 1 1 23 18 18 18 18 18 18 18 18 18 18 18 
18 18 18 18 18 18 18 18 18 18 18 24 16 1 1 38 1 1 1 1 1 2 1 2 1 16 16 1 1 39 1 1 1 1 1 2 1 1 23 18 18 18 18 18 18 18 18 18 18 18 
18 18 18 18 18 18 18 18 18 18 18 24 16 16 16 1 1 1 39 1 38 1 1 1 1 16 16 16 1 1 1 1 1 1 2 2 1 38 23 18 18 18 18 18 18 18 18 18 18 18 
18 18 18 18 18 18 18 18 18 18 18 24 16 16 16 16 16 16 1 1 1 16 1 1 1 1 16 16 16 1 1 1 2 1 1 1 1 1 23 18 18 18 18 18 18 18 18 18 18 18 
18 18 18 18 18 18 18 18 18 18 18 24 1 1 16 16 16 16 16 16 16 16 16 16 1 1 1 1 16 1 1 2 1 1 1 39 38 1 23 18 18 18 18 18 18 18 18 18 18 18 
18 18 18 18 18 18 18 18 18 18 18 24 38 1 1 1 16 16 16 16 16 16 16 1 1 1 1 1 1 1 1 1 2 1 1 1 1 16 23 18 18 18 18 18 18 18 18 18 18 18 
18 18 18 18 18 18 18 18 18 18 18 24 1 2 1 1 1 1 1 16 16 1 1 1 16 16 16 1 12 10 10 13 1 39 2 1 16 16 23 18 18 18 18 18 18 18 18 18 18 18 
18 18 18 18 18 18 18 18 18 18 18 24 1 1 1 1 1 1 1 16 16 1 16 16 16 16 1 1 8 3 3 7 16 16 1 16 16 16 23 18 18 18 18 18 18 18 18 18 18 18 
18 18 18 18 18 18 18 18 18 18 18 24 1 1 39 2 1 1 1 1 1 1 16 16 16 16 1 12 11 3 3 7 16 16 1 1 1 16 23 18 18 18 18 18 18 18 18 18 18 18 
18 18 18 18 18 18 18 18 18 18 18 24 1 2 1 1 2 38 1 16 16 16 16 16 16 1 1 8 3 3 4 15 16 16 16 16 1 16 23 18 18 18 18 18 18 18 18 18 18 18 
18 18 18 18 18 18 18 18 18 18 18 24 2 1 1 1 1 1 1 16 16 1 16 16 16 12 10 11 3 3 7 16 16 16 38 12 10 13 23 18 18 18 18 18 18 18 18 18 18 18 
18 18 18 18 18 18 18 18 18 18 18 24 1 39 1 1 1 1 1 1 1 1 2 16 16 8 3 3 3 3 7 16 16 16 12 11 3 7 23 18 18 18 18 18 18 18 18 18 18 18 
18 18 18 18 18 18 18 18 18 18 18 24 1 1 1 2 2 2 1 39 1 1 16 16 12 11 3 3 4 5 15 16 16 12 11 3 3 7 23 18 18 18 18 18 18 18 18 18 18 18 
18 18 18 18 18 18 18 18 18 18 18 24 1 38 1 1 2 1 2 2 1 16 16 16 8 3 3 3 7 16 16 16 12 11 3 3 4 15 23 18 18 18 18 18 18 18 18 18 18 18 
18 18 18 18 18 18 18 18 18 18 18 24 2 1 2 1 1 1 1 1 1 16 16 16 8 3 3 4 15 16 16 38 8 3 3 4 15 1 23 18 18 18 18 18 18 18 18 18 18 18 
18 18 18 18 18 18 18 18 18 18 18 24 1 32 32 34 32 1 1 38 1 16 16 12 11 3 3 7 1 16 16 39 8 3 4 15 1 1 23 18 18 18 18 18 18 18 18 18 18 18 
18 18 18 18 18 18 18 18 18 18 18 24 16 32 36 34 32 39 1 2 1 16 16 8 3 3 4 15 16 16 16 1 20 21 22 39 1 1 23 18 18 18 18 18 18 18 18 18 18 18 
18 18 18 18 18 18 18 18 18 18 18 24 16 32 32 32 32 16 16 1 16 16 16 8 3 3 7 1 16 16 16 16 25 26 27 1 38 1 23 18 18 18 18 18 18 18 18 18 18 18 
18 18 18 18 18 18 18 18 18 18 18 24 16 16 16 16 16 16 16 16 16 16 16 8 3 3 7 16 16 16 16 16 16 16 16 16 16 16 23 18 18 18 18 18 18 18 18 18 18 18 
18 18 18 18 18 18 18 18 18 18 18 24 16 16 16 16 16 16 1 1 1 12 10 11 32 34 32 32 32 32 32 32 32 32 32 32 32 16 23 18 18 18 18 18 18 18 18 18 18 18 
18 18 18 18 18 18 18 18 18 18 18 24 16 16 16 16 16 16 1 16 16 8 3 3 32 34 34 34 34 34 34 34 34 34 34 34 32 16 23 18 18 18 18 18 18 18 18 18 18 18 
18 18 18 18 18 18 18 18 18 18 18 24 16 16 16 16 1 1 1 16 16 16 5 5 32 34 34 34 34 34 34 34 34 34 34 34 32 16 23 18 18 18 18 18 18 18 18 18 18 18 
18 18 18 18 18 18 18 18 18 18 18 24 16 16 16 16 1 16 16 16 16 16 16 16 32 34 34 34 34 34 34 34 34 34 34 34 32 16 23 18 18 18 18 18 18 18 18 18 18 18 
18 18 18 18 18 18 18 18 18 18 18 24 16 16 16 16 1 16 16 16 16 16 16 16 32 34 34 34 34 34 34 34 34 34 34 34 32 16 23 18 18 18 18 18 18 18 18 18 18 18 
18 18 18 18 18 18 18 18 18 18 18 24 16 16 33 16 1 1 1 1 1 1 16 16 32 34 34 34 34 34 34 34 34 34 34 36 32 16 23 18 18 18 18 18 18 18 18 18 18 18 
18 18 18 18 18 18 18 18 18 18 18 24 16 16 1 16 16 16 16 16 1 16 16 16 32 32 32 32 32 32 32 32 32 32 32 32 32 16 23 18 18 18 18 18 18 18 18 18 18 18 
18 18 18 18 18 18 18 18 18 18 18 24 16 16 1 1 1 1 1 1 1 1 16 16 16 1 1 1 1 1 1 1 1 1 1 1 1 16 23 18 18 18 18 18 18 18 18 18 18 18 
18 18 18 18 18 18 18 18 18 18 18 30 21 21 21 21 21 21 21 21 21 21 21 21 21 21 21 21 21 21 21 21 21 21 21 21 21 21 31 18 18 18 18 18 18 18 18 18 18 18 
18 18 18 18 18 18 18 18 18 18 18 18 18 18 18 18 18 18 18 18 18 18 18 18 18 18 18 18 18 18 18 18 18 18 18 18 18 18 18 18 18 18 18 18 18 18 18 18 18 18 
18 18 18 18 18 18 18 18 18 18 18 18 18 18 18 18 18 18 18 18 18 18 18 18 18 18 18 18 18 18 18 18 18 18 18 18 18 18 18 18 18 18 18 18 18 18 18 18 18 18 
18 18 18 18 18 18 18 18 18 18 18 18 18 18 18 18 18 18 18 18 18 18 18 18 18 18 18 18 18 18 18 18 18 18 18 18 18 18 18 18 18 18 18 18 18 18 18 18 18 18 
18 18 18 18 18 18 18 18 18 18 18 18 18 18 18 18 18 18 18 18 18 18 18 18 18 18 18 18 18 18 18 18 18 18 18 18 18 18 18 18 18 18 18 18 18 18 18 18 18 18 
18 18 18 18 18 18 18 18 18 18 18 18 18 18 18 18 18 18 18 18 18 18 18 18 18 18 18 18 18 18 18 18 18 18 18 18 18 18 18 18 18 18 18 18 18 18 18 18 18 18 
18 18 18 18 18 18 18 18 18 18 18 18 18 18 18 18 18 18 18 18 18 18 18 18 18 18 18 18 18 18 18 18 18 18 18 18 18 18 18 18 18 18 18 18 18 18 18 18 18 18 
18 18 18 18 18 18 18 18 18 18 18 18 18 18 18 18 18 18 18 18 18 18 18 18 18 18 18 18 18 18 18 18 18 18 18 18 18 18 18 18 18 18 18 18 18 18 18 18 18 18 
18 18 18 18 18 18 18 18 18 18 18 18 18 18 18 18 18 18 18 18 18 18 18 18 18 18 18 18 18 18 18 18 18 18 18 18 18 18 18 18 18 18 18 18 18 18 18 18 18 18 
