95 95 53 53 95 54 95 54 95 95 95 57 53 53 53 53 53 95 95 95 53 95 53 95 95 53 53 53 53 53 53 53 53 95 95 95 95 95 95 95 95 95 95 95 95 95 95 95 95 95 
95 95 54 95 53 95 54 54 95 95 95 53 53 53 95 95 95 95 95 95 95 95 95 53 95 95 57 95 53 53 53 53 53 53 53 95 53 58 56 95 95 95 95 95 95 95 95 95 95 95 
68 68 95 95 95 53 53 95 95 53 53 53 95 95 95 95 95 95 95 95 95 95 53 95 95 95 95 53 53 53 53 53 53 96 53 53 53 53 53 95 95 95 95 56 95 95 95 95 95 95 
68 68 68 95 57 57 95 95 95 95 95 95 95 95 95 95 95 95 53 53 56 95 53 57 95 53 58 96 96 96 53 53 96 96 96 96 53 58 53 95 53 53 95 56 53 95 95 53 95 95 
68 68 68 95 95 54 95 95 53 96 96 95 95 95 95 95 95 96 95 58 95 95 95 57 58 96 96 96 96 96 96 96 96 96 96 96 96 53 53 96 96 96 56 56 56 56 95 95 95 95 
68 68 68 68 68 95 95 95 96 96 96 96 96 95 95 95 96 96 96 96 96 95 53 96 96 96 96 96 96 96 96 96 96 96 96 96 96 96 96 96 96 96 96 96 95 56 95 95 95 95 
68 68 68 68 68 95 95 95 96 96 96 96 96 96 96 96 96 96 96 96 96 96 96 96 96 96 96 96 96 96 96 96 96 96 96 96 96 96 96 96 96 96 96 96 96 95 95 95 95 95 
68 68 68 68 68 68 68 96 96 96 96 96 96 96 96 96 96 96 96 96 96 96 96 96 96 96 96 96 96 96 96 96 96 96 96 96 96 96 96 96 96 96 96 96 95 95 95 95 95 95 
68 68 68 68 68 96 96 96 96 96 191 192 192 192 192 192 192 192 192 192 192 192 192 192 192 192 192 192 192 192 192 192 192 192 192 192 192 192 192 193 96 96 96 95 95 95 56 53 95 95 
68 68 68 68 68 96 96 96 96 96 194 195 195 195 195 195 195 195 195 195 195 195 195 195 195 195 195 195 195 195 195 195 195 195 195 195 195 195 195 196 96 96 96 95 95 95 95 95 95 95 
68 68 68 68 68 96 96 96 96 96 194 195 191 192 193 195 195 195 195 195 195 195 195 195 195 195 195 195 195 195 195 195 195 195 195 191 192 193 195 196 96 96 96 95 95 95 95 95 95 95 
68 68 68 68 68 96 96 96 96 96 194 195 194 195 196 195 195 195 195 195 195 195 195 195 195 195 195 195 195 195 195 195 195 195 195 194 195 196 195 196 96 96 96 96 95 95 95 54 95 95 
68 68 68 68 68 96 96 96 96 96 194 195 197 198 199 195 195 195 195 195 195 195 195 195 195 195 195 195 195 195 195 195 195 195 195 197 198 199 195 196 96 96 96 96 96 95 95 95 95 95 
68 68 68 68 68 96 96 96 96 96 194 195 195 195 195 195 195 195 195 195 195 195 195 195 195 195 195 195 195 195 195 195 195 195 195 195 195 195 195 196 96 96 96 96 96 53 95 53 95 95 
68 68 68 68 68 96 96 96 96 96 194 195 195 195 195 195 195 195 195 195 195 195 195 195 195 195 195 195 195 195 195 195 195 195 195 195 195 195 195 196 96 96 96 96 96 53 95 95 95 95 
68 68 68 68 68 96 96 96 96 96 194 195 195 195 195 195 195 195 195 195 195 195 195 195 195 195 195 195 195 195 195 195 195 195 195 195 195 195 195 196 96 96 96 96 96 53 95 95 95 95 
68 68 68 68 68 68 96 96 96 96 194 195 195 195 195 195 195 195 195 195 195 195 195 195 195 195 195 195 195 195 195 195 195 195 195 195 195 195 195 196 96 96 96 95 95 95 53 95 95 95 
68 68 68 68 68 68 96 96 96 96 194 195 195 195 195 195 195 195 195 195 195 195 195 195 195 195 195 195 195 195 195 195 195 195 195 195 195 195 195 196 96 96 96 95 95 95 95 53 53 95 
68 68 95 95 95 95 96 96 96 96 194 195 191 192 193 195 195 195 195 195 195 195 195 195 195 195 195 195 195 195 195 195 195 195 195 191 192 193 195 196 96 96 96 96 95 95 53 95 95 95 
68 68 95 95 95 95 96 96 96 96 194 195 194 195 196 195 195 195 195 195 195 195 195 195 195 195 195 195 195 195 195 195 195 195 195 194 195 196 195 196 96 96 96 96 96 95 53 95 95 95 
68 68 55 95 95 95 96 96 96 96 194 195 197 198 199 195 195 195 195 195 195 195 195 195 195 195 195 195 195 195 195 195 195 195 195 197 198 199 195 196 96 96 96 96 96 53 53 95 95 95 
68 95 95 95 95 96 96 96 96 96 194 195 195 195 195 195 195 195 195 195 195 195 195 195 195 195 195 195 195 195 195 195 195 195 195 195 195 195 195 196 96 96 96 96 96 95 53 95 95 95 
95 95 95 95 95 96 96 96 96 96 197 198 198 198 198 198 198 198 198 198 198 198 198 198 198 198 198 198 198 198 198 198 198 198 198 198 198 198 198 199 96 96 96 96 96 53 56 95 95 95 
95 95 95 95 95 96 96 96 96 96 200 204 204 204 204 204 204 204 204 204 204 204 204 204 204 204 204 204 204 204 204 204 204 204 204 204 204 204 204 202 96 96 96 96 95 95 95 95 95 95 
95 95 95 95 95 96 96 96 96 96 203 204 204 204 204 204 204 204 204 204 204 204 204 204 204 204 204 204 204 204 204 204 204 204 204 209 210 211 204 205 96 96 96 96 95 95 95 95 95 95 
95 95 95 95 95 96 96 96 96 96 203 204 204 204 204 204 204 204 204 204 204 204 204 204 204 204 204 204 204 204 204 204 204 204 204 212 213 214 204 205 96 96 96 95 95 95 95 95 95 95 
95 55 95 53 96 96 96 96 96 96 206 207 207 207 207 207 207 207 207 207 207 207 207 207 207 207 207 207 207 207 207 207 207 207 207 215 217 216 207 208 96 96 96 96 56 95 95 95 95 95 
95 95 95 95 96 96 96 96 96 96 95 95 95 95 95 95 95 95 95 95 95 95 95 95 95 95 95 95 95 95 95 95 95 95 95 95 95 95 95 95 96 96 96 96 53 95 95 95 95 95 
55 95 95 55 96 96 96 96 96 96 95 95 95 95 95 95 95 95 95 95 95 95 95 95 95 95 95 95 95 95 95 95 95 95 95 95 95 95 95 95 96 96 96 96 53 95 95 95 95 95 
55 95 95 95 96 96 96 96 96 96 96 96 95 95 95 95 95 95 95 96 96 96 96 95 95 95 95 95 95 95 96 96 96 96 95 95 95 95 95 96 96 96 96 96 95 95 95 95 95 95 
95 95 95 95 96 96 96 96 96 96 96 96 96 95 95 95 95 95 96 96 96 96 96 96 95 95 95 95 96 96 96 96 96 96 96 96 95 95 95 96 96 96 96 96 95 95 56 95 95 95 
95 95 95 56 96 96 96 96 96 96 96 96 96 96 96 96 95 95 96 96 96 96 96 96 96 96 95 96 96 96 96 96 96 96 96 96 96 96 96 96 96 96 96 96 53 56 95 95 95 95 
95 95 95 55 96 96 96 96 96 96 96 96 96 96 96 96 96 95 95 95 95 96 96 96 96 96 96 96 96 96 96 96 96 96 96 96 96 96 96 96 96 96 96 53 53 95 95 95 95 95 
95 56 95 55 96 96 96 96 96 96 96 96 96 96 96 96 96 96 96 96 95 96 96 96 96 96 96 96 96 96 96 96 96 96 96 96 96 96 96 96 96 96 96 95 56 95 95 95 95 95 
95 95 95 55 95 95 95 96 96 96 96 96 96 96 96 96 96 96 96 96 95 96 96 96 96 96 96 96 96 96 96 96 96 96 95 96 96 96 96 96 96 96 96 96 53 95 95 95 95 95 
95 95 95 95 55 55 95 96 96 96 96 96 96 96 96 96 96 96 96 96 95 96 96 96 96 96 96 96 96 96 96 96 95 95 95 95 95 96 96 96 96 96 96 96 53 95 95 95 95 95 
95 95 95 55 56 95 96 96 96 96 96 96 96 96 96 96 96 96 96 96 95 95 95 96 96 96 96 96 96 96 96 95 60 61 61 61 62 95 96 96 96 96 96 96 53 95 95 95 95 95 
95 95 95 95 55 95 96 96 96 96 96 96 96 96 96 96 96 96 96 96 96 96 95 95 95 95 95 96 96 96 95 95 67 95 95 95 69 95 96 96 96 96 96 96 54 54 95 95 95 95 
95 95 95 55 95 96 96 96 96 96 96 96 96 96 96 96 96 96 96 96 96 96 96 96 96 96 95 96 96 96 95 95 74 75 188 75 76 95 96 96 96 96 96 96 53 53 54 95 95 95 
95 95 95 95 95 96 96 96 96 96 96 96 96 96 96 96 96 96 96 96 96 96 96 96 96 96 95 95 96 96 95 95 81 82 186 82 83 95 96 96 96 96 96 54 95 95 53 95 95 95 
95 95 95 95 95 96 96 96 96 96 96 96 96 96 96 96 96 96 96 96 96 96 96 96 96 96 96 95 95 95 95 95 81 82 186 82 83 95 96 96 96 96 95 53 53 53 53 53 95 95 
95 95 95 95 95 96 96 96 96 96 96 96 96 96 96 96 96 96 96 96 96 96 96 96 96 96 96 96 96 95 95 95 88 89 187 89 90 95 96 96 96 96 95 95 95 95 95 95 95 95 
95 95 95 95 95 95 95 95 95 96 96 96 96 96 96 96 96 96 96 96 96 96 96 96 96 96 96 96 95 95 95 95 95 95 95 95 95 95 96 96 96 96 53 95 56 53 53 95 95 95 
95 95 95 95 95 95 95 95 95 95 96 96 96 96 96 96 96 96 96 96 96 96 96 96 96 96 96 96 96 96 96 96 96 96 96 96 96 96 96 96 96 96 95 56 95 95 95 95 95 95 
95 95 95 95 95 95 95 95 95 95 95 95 96 96 96 96 96 96 96 96 96 95 95 96 96 96 96 96 96 96 96 96 96 96 96 95 95 95 96 96 96 95 95 53 95 95 95 95 95 95 
95 95 95 55 55 55 95 95 95 95 95 95 95 96 96 96 96 95 95 95 95 95 95 95 95 95 95 95 95 95 95 95 95 95 95 95 95 95 95 95 96 95 56 95 95 95 95 95 95 95 
95 95 95 95 95 55 95 95 95 95 95 95 95 95 96 95 95 95 95 95 95 95 95 95 95 95 95 95 95 95 95 95 95 95 95 95 95 95 95 95 95 56 56 95 54 95 95 95 95 95 
95 95 95 95 95 55 95 95 95 95 95 95 95 95 95 55 95 95 95 95 95 95 95 95 95 95 95 95 95 95 95 95 54 54 95 95 95 95 95 95 95 95 95 95 95 53 95 56 95 95 
95 95 95 95 95 95 95 95 95 95 95 55 55 95 95 95 95 95 95 95 95 95 95 95 54 95 95 95 95 95 54 95 95 95 95 95 95 53 95 95 95 53 95 95 95 95 95 56 95 95 
95 95 95 95 95 95 95 95 95 95 95 95 95 95 95 95 95 95 95 95 95 95 95 95 95 95 95 95 95 95 95 95 95 95 95 95 95 95 95 95 95 56 95 95 56 54 95 95 95 95 
