95 95 53 53 95 54 95 54 95 95 95 57 53 53 53 53 53 95 95 95 53 95 53 95 95 53 53 53 53 53 53 53 53 95 95 95 95 95 95 95 95 95 95 95 95 95 95 95 95 95 
95 95 54 95 53 95 54 54 95 95 95 53 53 53 95 95 95 95 95 95 95 95 95 53 95 95 57 95 53 53 53 53 53 53 53 95 53 58 56 95 95 95 95 95 95 95 95 95 95 95 
95 53 95 95 95 53 53 95 95 53 53 53 95 95 95 95 95 95 95 95 95 95 53 95 95 95 95 53 53 53 53 53 53 96 53 53 53 53 53 95 95 95 95 56 95 95 95 95 95 95 
57 53 95 95 57 57 95 95 95 95 95 95 95 95 95 95 95 95 53 53 56 95 53 57 95 53 58 96 96 96 53 53 96 96 96 96 53 58 53 95 53 53 95 56 53 95 95 53 95 95 
95 95 53 95 95 54 95 95 53 96 96 95 95 95 95 95 95 96 95 58 95 95 95 57 58 96 96 96 96 96 96 96 96 96 96 96 96 53 53 96 96 96 56 56 56 56 95 95 95 95 
53 95 95 53 95 95 95 95 96 96 96 96 96 95 95 95 96 96 96 96 96 95 53 96 96 96 96 96 96 96 96 96 96 96 96 96 96 96 96 96 96 96 96 96 95 56 95 95 95 95 
53 95 95 95 95 95 95 95 96 96 96 96 96 96 96 96 96 96 96 96 96 96 96 96 96 96 96 96 96 96 96 96 96 96 96 96 96 96 96 96 96 96 96 96 96 95 95 95 95 95 
95 95 95 95 95 95 95 96 96 96 96 96 96 96 96 96 96 96 96 96 96 96 96 96 96 96 96 96 96 96 96 96 96 96 96 96 96 96 96 96 96 96 96 96 95 95 95 95 95 95 
57 57 95 95 95 95 96 96 96 96 96 96 96 96 96 96 96 96 96 96 96 96 96 96 96 96 96 96 96 96 96 96 96 96 96 96 96 96 96 96 96 96 96 95 95 95 56 53 95 95 
95 95 95 95 95 95 96 96 96 96 96 96 96 53 95 95 53 95 53 56 95 96 96 96 96 53 68 95 95 53 58 95 54 53 95 53 95 53 95 96 96 96 96 95 95 95 95 95 95 95 
95 95 95 95 95 95 95 96 96 96 96 119 68 68 68 68 68 68 68 68 68 68 68 96 96 96 68 68 68 68 68 68 68 68 68 68 68 68 58 96 96 96 96 95 95 95 95 95 95 95 
95 95 95 95 95 95 95 96 96 96 96 68 68 68 68 68 68 68 68 68 68 68 68 68 96 96 96 68 68 68 68 68 68 68 68 68 68 68 53 96 96 96 96 96 95 95 95 54 95 95 
95 95 95 56 95 96 96 96 96 96 96 68 68 68 68 68 68 68 68 68 68 68 68 68 68 96 96 68 68 68 68 68 68 68 68 68 68 68 58 96 96 96 96 96 96 95 95 95 95 95 
95 95 95 95 95 96 96 96 96 96 96 68 68 68 68 68 68 68 68 68 68 68 68 68 68 96 96 68 68 68 68 68 68 68 68 68 68 68 95 96 96 96 96 96 96 53 95 53 95 95 
95 95 95 95 96 96 96 96 96 96 96 95 68 68 68 68 68 68 68 68 68 68 68 68 68 96 96 96 68 68 68 68 68 68 68 68 68 68 68 96 96 96 96 96 96 53 95 95 95 95 
95 95 95 95 96 96 96 96 96 96 96 95 68 68 68 68 68 68 68 68 68 68 68 68 68 96 96 96 68 68 68 68 68 68 68 68 68 68 68 96 96 96 96 96 96 53 95 95 95 95 
95 95 95 95 95 96 96 96 96 96 96 95 68 68 68 68 68 68 68 68 68 68 68 68 68 96 96 96 68 68 68 68 68 68 68 68 68 68 68 96 96 96 96 95 95 95 53 95 95 95 
95 95 95 95 95 96 96 96 96 96 96 95 68 68 68 68 68 68 68 68 68 68 68 68 68 96 96 96 68 68 68 68 68 68 68 68 68 68 68 96 96 96 96 95 95 95 95 53 53 95 
95 95 95 95 95 95 96 96 96 96 96 95 68 68 68 68 68 68 68 68 68 68 68 68 68 96 96 96 68 68 68 68 68 68 68 68 68 68 95 96 96 96 96 96 95 95 53 95 95 95 
95 95 95 95 95 95 96 96 96 96 96 95 68 68 68 68 68 68 68 68 68 68 68 68 68 96 96 68 68 68 68 68 68 68 68 68 68 68 95 96 96 96 96 96 96 95 53 95 95 95 
95 95 55 95 95 95 96 96 96 96 96 68 68 68 68 68 68 68 68 68 68 68 68 68 96 96 96 68 68 68 68 68 68 68 68 68 68 68 95 96 96 96 96 96 96 53 53 95 95 95 
95 95 95 95 95 96 96 96 96 96 96 68 68 68 68 68 68 96 96 96 96 95 96 96 96 96 96 96 68 68 68 68 68 68 68 68 68 68 56 96 96 96 96 96 96 95 53 95 95 95 
95 95 95 95 95 96 96 96 96 96 96 96 96 96 96 96 96 96 96 96 96 95 95 96 96 96 96 96 96 68 68 68 68 68 68 68 68 96 96 96 96 96 96 96 96 53 56 95 95 95 
95 95 95 95 95 96 96 96 96 96 96 96 96 96 96 96 96 96 68 68 68 68 68 68 68 68 68 96 96 96 68 68 96 96 96 96 96 96 96 96 96 96 96 96 95 95 95 95 95 95 
95 95 95 95 95 96 96 96 96 96 96 96 96 68 68 68 68 68 68 68 68 68 68 68 68 96 96 96 96 96 96 96 96 96 96 96 96 96 96 96 96 96 96 96 95 95 95 95 95 95 
95 95 95 95 95 96 96 96 96 96 96 68 68 68 68 68 68 68 68 68 68 68 68 68 68 96 96 68 68 68 68 68 68 68 68 68 68 96 96 96 96 96 96 95 95 95 95 95 95 95 
95 55 95 53 96 96 96 96 96 96 96 68 68 68 68 68 68 68 68 68 68 68 68 68 96 96 96 68 68 68 68 68 68 68 68 68 68 68 96 96 96 96 96 96 56 95 95 95 95 95 
95 95 95 95 96 96 96 96 96 96 96 95 68 68 68 68 68 68 68 68 68 68 68 68 96 96 96 68 68 68 68 68 68 68 68 68 68 68 96 96 96 96 96 96 53 95 95 95 95 95 
55 95 95 55 96 96 96 96 96 96 96 55 68 68 68 68 68 68 68 68 68 68 68 68 96 96 96 68 68 68 68 68 68 68 68 68 68 68 96 96 96 96 96 96 53 95 95 95 95 95 
55 95 95 95 96 96 96 96 96 96 96 53 68 68 68 68 68 68 68 68 68 68 68 68 96 96 96 68 68 68 68 68 68 68 68 68 68 68 87 96 96 96 96 96 95 95 95 95 95 95 
95 95 95 95 96 96 96 96 96 96 96 56 68 68 68 68 68 68 68 68 68 68 68 68 96 96 96 68 68 68 68 68 68 68 68 68 68 68 73 96 96 96 96 96 95 95 56 95 95 95 
95 95 95 56 96 96 96 96 96 96 96 95 68 68 68 68 68 68 68 68 68 68 68 68 96 96 96 68 68 68 68 68 68 68 68 68 68 68 95 96 96 96 96 96 53 56 95 95 95 95 
95 95 95 55 96 96 96 96 96 96 96 55 68 68 68 68 68 68 68 68 68 68 68 96 96 96 68 68 68 68 68 68 68 68 68 68 68 68 53 96 96 96 96 53 53 95 95 95 95 95 
95 56 95 55 96 96 96 96 96 96 96 55 68 68 68 68 68 68 68 68 96 96 96 96 96 96 96 68 68 68 68 68 68 68 68 68 68 68 95 96 96 96 96 95 56 95 95 95 95 95 
95 95 95 55 95 95 95 96 96 96 96 96 96 96 96 96 96 96 96 96 96 96 96 68 68 96 96 96 96 68 68 68 68 68 68 68 68 68 96 96 96 96 96 96 53 95 95 95 95 95 
95 95 95 95 55 55 95 96 96 96 96 96 96 96 96 96 96 96 96 96 68 68 68 68 68 68 96 96 96 96 96 68 68 68 68 68 68 68 96 96 96 96 96 96 53 95 95 95 95 95 
95 95 95 55 56 95 96 96 96 96 96 96 96 96 68 68 68 68 68 68 68 68 68 68 68 68 68 68 68 96 96 96 96 68 68 68 68 68 96 96 96 96 96 96 53 95 95 95 95 95 
95 95 95 95 55 95 96 96 96 96 96 55 95 53 68 68 68 68 68 68 68 68 68 68 68 68 68 68 68 68 96 96 96 96 96 68 68 68 96 96 96 96 96 96 54 54 95 95 95 95 
95 95 95 55 95 96 96 96 96 96 96 95 55 53 68 68 68 68 68 68 68 68 68 68 68 68 68 68 68 68 68 96 96 96 96 96 95 95 106 96 96 96 96 96 53 53 54 95 95 95 
95 95 95 95 95 96 96 96 96 96 96 96 59 95 68 68 68 68 68 68 68 68 68 68 68 68 68 68 68 68 54 95 95 96 96 96 96 96 96 96 96 96 96 54 95 95 53 95 95 95 
95 95 95 95 95 96 96 96 96 96 96 96 96 96 95 95 95 95 95 55 95 95 95 95 53 53 95 95 55 95 54 95 95 95 96 96 96 96 96 96 96 96 95 53 53 53 53 53 95 95 
95 95 95 95 95 96 96 96 96 96 96 96 96 96 96 96 96 96 96 96 96 96 96 96 96 96 96 96 96 96 96 96 96 96 96 96 96 96 96 96 96 96 95 95 95 95 95 95 95 95 
95 95 95 95 95 95 95 95 95 96 96 96 96 96 96 96 96 96 96 96 96 96 96 96 96 96 96 96 96 96 96 96 96 96 96 96 96 96 96 96 96 96 53 95 56 53 53 95 95 95 
95 95 95 95 95 95 95 95 95 95 96 96 96 96 96 96 96 96 96 96 96 96 96 96 96 96 96 96 96 96 96 96 96 96 96 96 96 96 96 96 96 96 95 56 95 95 95 95 95 95 
95 95 95 95 95 95 95 95 95 95 95 95 96 96 96 96 96 96 96 96 96 95 95 96 96 96 96 96 96 96 96 96 96 96 96 95 95 95 96 96 96 95 95 53 95 95 95 95 95 95 
95 95 95 55 55 55 95 95 95 95 95 95 95 96 96 96 96 95 95 95 95 95 95 95 95 95 95 95 95 95 95 95 95 95 95 95 95 95 95 95 96 95 56 95 95 95 95 95 95 95 
95 95 95 95 95 55 95 95 95 95 95 95 95 95 96 95 95 95 95 95 95 95 95 95 95 95 95 95 95 95 95 95 95 95 95 95 95 95 95 95 95 56 56 95 54 95 95 95 95 95 
95 95 95 95 95 55 95 95 95 95 95 95 95 95 95 55 95 95 95 95 95 95 95 95 95 95 95 95 95 95 95 95 54 54 95 95 95 95 95 95 95 95 95 95 95 53 95 56 95 95 
95 95 95 95 95 95 95 95 95 95 95 55 55 95 95 95 95 95 95 95 95 95 95 95 54 95 95 95 95 95 54 95 95 95 95 95 95 53 95 95 95 53 95 95 95 95 95 56 95 95 
95 95 95 95 95 95 95 95 95 95 95 95 95 95 95 95 95 95 95 95 95 95 95 95 95 95 95 95 95 95 95 95 95 95 95 95 95 95 95 95 95 56 95 95 56 54 95 95 95 95 
