0 0 0 0 0 0 0 0 0 0 0 0 0 0 0 0 0 0 0 0 0 0 0 0 0 0 0 0 0 0 0 0 0 0 0 0 0 0 0 0 0 0 0 0 0 0 0 0 0 0 
0 0 0 0 0 0 0 0 0 0 0 0 0 0 0 0 0 0 0 0 0 0 0 0 0 0 0 0 0 0 0 0 0 0 0 0 0 0 0 0 0 0 0 0 0 0 0 0 0 0 
0 0 0 0 0 0 0 0 0 0 0 0 0 0 0 0 0 0 0 0 0 0 0 0 0 0 0 0 0 0 0 0 0 0 0 0 0 0 0 0 0 0 0 0 0 0 0 0 0 0 
0 0 0 0 0 0 0 0 0 0 0 0 0 0 0 0 0 0 0 0 0 0 0 0 0 0 0 0 0 0 0 0 0 0 0 0 0 0 0 0 0 0 0 0 0 0 0 0 0 0 
0 0 0 0 0 0 0 0 0 0 0 0 0 0 0 0 0 0 0 0 0 0 0 0 0 0 0 0 0 0 0 0 0 0 0 0 0 0 0 0 0 0 0 0 0 0 0 0 0 0 
0 0 0 0 0 0 0 0 0 0 0 0 0 0 0 0 0 0 0 0 0 0 0 0 0 0 0 0 0 0 0 0 0 0 0 0 0 0 0 0 0 0 0 0 0 0 0 0 0 0 
0 0 0 0 0 0 0 0 0 0 0 0 0 0 0 0 0 0 0 0 0 0 0 0 0 0 0 0 0 0 0 0 0 0 0 0 0 0 0 0 0 0 0 0 0 0 0 0 0 0 
0 0 0 0 0 0 0 0 0 0 0 0 0 0 0 0 0 0 0 0 0 0 0 0 0 0 0 0 0 0 0 0 0 0 0 0 0 0 0 0 0 0 0 0 0 0 0 0 0 0 
0 0 0 0 0 0 0 0 0 165 166 166 166 166 166 166 166 166 166 167 165 166 166 167 0 165 166 166 167 165 166 166 166 166 166 166 166 166 166 167 0 0 0 0 0 0 0 0 0 0 
0 0 0 0 0 0 0 0 0 172 176 176 176 176 176 176 176 176 176 173 172 152 152 152 152 152 152 152 173 172 176 176 176 176 176 176 176 176 176 173 0 0 0 0 0 0 0 0 0 0 
0 0 0 0 0 0 0 0 0 172 176 176 176 176 176 176 176 176 176 173 172 152 152 183 184 137 152 152 173 172 176 176 176 176 176 176 176 176 176 173 0 0 0 0 0 0 0 0 0 0 
0 0 0 0 0 0 0 0 0 172 176 176 176 176 176 176 176 176 176 173 172 152 152 141 142 143 152 152 173 172 176 176 176 176 176 176 176 176 176 173 0 0 0 0 0 0 0 0 0 0 
0 0 0 0 0 0 0 0 0 172 176 176 176 176 176 176 176 176 176 173 172 152 152 141 142 143 152 152 173 172 176 176 176 176 176 176 176 176 176 173 0 0 0 0 0 0 0 0 0 0 
0 0 0 0 0 0 0 0 0 172 176 176 176 176 176 176 176 176 176 173 172 152 152 141 142 143 152 152 173 172 176 176 176 176 176 176 176 176 176 173 0 0 0 0 0 0 0 0 0 0 
0 0 0 0 0 0 0 0 0 172 176 176 176 176 176 176 176 176 176 173 172 152 152 141 142 143 152 152 173 172 176 176 176 176 176 176 176 176 176 173 0 0 0 0 0 0 0 0 0 0 
0 0 0 0 0 0 0 0 0 172 176 176 176 176 176 176 176 176 176 173 172 152 152 141 142 143 152 152 173 172 176 176 176 176 176 176 176 176 176 173 0 0 0 0 0 0 0 0 0 0 
0 0 0 0 0 0 0 0 0 172 176 176 176 176 176 176 176 176 176 147 147 152 152 141 142 143 152 152 147 147 176 176 176 176 176 176 176 176 176 173 0 0 0 0 0 0 0 0 0 0 
0 0 0 0 0 0 0 0 0 172 176 176 176 176 176 176 176 176 176 154 154 152 152 155 156 157 152 152 154 154 176 176 176 176 176 176 176 176 176 173 0 0 0 0 0 0 0 0 0 0 
0 0 0 0 0 0 0 0 0 172 176 176 176 176 176 176 176 176 176 161 161 152 152 155 156 157 152 152 161 161 176 176 176 176 176 176 176 176 176 173 0 0 0 0 0 0 0 0 0 0 
0 0 0 0 0 0 0 0 0 172 176 176 176 176 176 176 176 176 176 173 172 152 152 155 156 157 152 152 173 172 176 176 176 176 176 176 176 176 176 173 0 0 0 0 0 0 0 0 0 0 
0 0 0 0 0 0 0 0 0 172 181 181 181 181 181 181 181 181 181 173 172 152 152 141 142 143 152 152 173 172 181 181 181 181 181 181 181 181 181 173 0 0 0 0 0 0 0 0 0 0 
0 0 0 0 0 0 0 0 0 172 152 152 152 152 152 152 152 152 152 173 172 152 152 141 142 143 152 152 173 172 152 152 152 152 152 152 152 152 152 173 0 0 0 0 0 0 0 0 0 0 
0 0 0 0 0 0 0 0 0 172 152 152 152 152 152 152 152 152 152 173 172 152 152 141 142 143 152 152 173 172 152 152 152 152 152 152 152 152 152 173 0 0 0 0 0 0 0 0 0 0 
0 0 0 0 0 0 0 0 0 172 152 152 152 152 152 152 152 152 152 173 172 152 152 141 142 143 152 152 173 172 152 152 152 152 152 152 152 152 152 173 0 0 0 0 0 0 0 0 0 0 
0 0 0 0 0 0 0 0 0 172 152 152 152 152 152 152 152 152 152 173 172 152 152 141 142 143 152 152 173 172 152 152 152 152 152 152 152 152 152 173 0 0 0 0 0 0 0 0 0 0 
0 0 0 0 0 0 0 0 0 172 152 152 152 152 152 152 152 152 152 173 172 152 152 141 142 143 152 152 173 172 152 152 152 152 152 152 152 152 152 173 0 0 0 0 0 0 0 0 0 0 
0 0 0 0 0 0 0 0 0 172 152 152 152 152 152 152 152 152 152 173 172 152 152 141 142 143 152 152 173 172 152 152 152 152 152 152 152 152 152 173 0 0 0 0 0 0 0 0 0 0 
0 0 0 0 0 0 0 0 0 172 152 152 152 152 152 152 152 152 152 173 172 152 152 141 142 143 152 152 173 172 152 152 152 152 152 152 152 152 152 173 0 0 0 0 0 0 0 0 0 0 
0 0 0 0 0 0 0 0 0 172 152 152 152 152 152 152 152 152 152 173 172 152 152 141 142 143 152 152 173 172 152 152 152 152 152 152 152 152 152 173 0 0 0 0 0 0 0 0 0 0 
0 0 0 0 0 0 0 0 0 172 152 152 152 152 152 152 152 152 152 173 147 147 152 141 142 143 152 147 147 172 152 152 152 152 152 152 152 152 152 173 0 0 0 0 0 0 0 0 0 0 
0 0 0 0 0 0 0 0 0 172 170 170 170 170 170 170 170 170 170 170 154 154 152 141 142 143 152 154 154 170 170 170 170 170 170 170 170 170 170 173 0 0 0 0 0 0 0 0 0 0 
0 0 0 0 0 0 0 0 0 172 176 176 176 176 176 176 176 176 176 176 161 161 152 155 156 157 152 161 161 176 176 176 176 176 176 176 176 176 176 173 0 0 0 0 0 0 0 0 0 0 
0 0 0 0 0 0 0 0 0 172 176 176 176 176 176 176 176 176 176 176 173 172 152 155 156 157 152 173 172 176 176 176 176 176 176 176 176 176 176 173 0 0 0 0 0 0 0 0 0 0 
0 0 0 0 0 0 0 0 0 172 176 176 176 176 176 176 176 176 176 176 173 172 152 155 156 157 152 173 172 176 176 176 176 176 176 176 176 176 176 173 0 0 0 0 0 0 0 0 0 0 
0 0 0 0 0 0 0 0 0 172 176 176 176 176 176 176 176 176 176 176 173 172 152 155 156 157 152 173 172 176 176 176 176 176 176 176 176 176 176 173 0 0 0 0 0 0 0 0 0 0 
0 0 0 0 0 0 0 0 0 172 176 176 176 176 176 176 176 176 176 176 173 172 152 141 142 143 152 173 172 176 176 176 176 176 176 176 176 176 176 173 0 0 0 0 0 0 0 0 0 0 
0 0 0 0 0 0 0 0 0 172 176 176 176 176 176 176 176 176 176 176 173 172 152 141 142 143 152 173 172 176 176 176 176 176 176 176 176 176 176 173 0 0 0 0 0 0 0 0 0 0 
0 0 0 0 0 0 0 0 0 172 176 176 176 176 176 176 176 176 176 176 173 172 152 141 142 143 152 173 172 176 176 176 176 176 176 176 176 176 176 173 0 0 0 0 0 0 0 0 0 0 
0 0 0 0 0 0 0 0 0 172 176 176 176 176 176 176 176 176 176 176 173 172 152 141 142 143 152 173 172 176 176 176 176 176 176 176 176 176 176 173 0 0 0 0 0 0 0 0 0 0 
0 0 0 0 0 0 0 0 0 172 176 176 176 176 176 176 176 176 176 176 173 172 152 148 149 150 152 173 172 176 176 176 176 176 176 176 176 176 176 173 0 0 0 0 0 0 0 0 0 0 
0 0 0 0 0 0 0 0 0 172 176 176 176 176 176 176 176 176 176 176 173 172 152 152 152 152 152 173 172 176 176 176 176 176 176 176 176 176 176 173 0 0 0 0 0 0 0 0 0 0 
0 0 0 0 0 0 0 0 0 134 135 135 135 135 135 135 135 135 135 135 136 134 135 136 152 134 135 136 134 135 135 135 135 135 135 135 135 135 135 136 0 0 0 0 0 0 0 0 0 0 
0 0 0 0 0 0 0 0 0 0 0 0 0 0 0 0 0 0 0 0 0 0 0 0 0 0 0 0 0 0 0 0 0 0 0 0 0 0 0 0 0 0 0 0 0 0 0 0 0 0 
0 0 0 0 0 0 0 0 0 0 0 0 0 0 0 0 0 0 0 0 0 0 0 0 0 0 0 0 0 0 0 0 0 0 0 0 0 0 0 0 0 0 0 0 0 0 0 0 0 0 
0 0 0 0 0 0 0 0 0 0 0 0 0 0 0 0 0 0 0 0 0 0 0 0 0 0 0 0 0 0 0 0 0 0 0 0 0 0 0 0 0 0 0 0 0 0 0 0 0 0 
0 0 0 0 0 0 0 0 0 0 0 0 0 0 0 0 0 0 0 0 0 0 0 0 0 0 0 0 0 0 0 0 0 0 0 0 0 0 0 0 0 0 0 0 0 0 0 0 0 0 
0 0 0 0 0 0 0 0 0 0 0 0 0 0 0 0 0 0 0 0 0 0 0 0 0 0 0 0 0 0 0 0 0 0 0 0 0 0 0 0 0 0 0 0 0 0 0 0 0 0 
0 0 0 0 0 0 0 0 0 0 0 0 0 0 0 0 0 0 0 0 0 0 0 0 0 0 0 0 0 0 0 0 0 0 0 0 0 0 0 0 0 0 0 0 0 0 0 0 0 0 
0 0 0 0 0 0 0 0 0 0 0 0 0 0 0 0 0 0 0 0 0 0 0 0 0 0 0 0 0 0 0 0 0 0 0 0 0 0 0 0 0 0 0 0 0 0 0 0 0 0 
0 0 0 0 0 0 0 0 0 0 0 0 0 0 0 0 0 0 0 0 0 0 0 0 0 0 0 0 0 0 0 0 0 0 0 0 0 0 0 0 0 0 0 0 0 0 0 0 0 0 
