125 125 125 125 125 125 125 125 125 125 125 125 125 125 125 125 125 125 125 125 125 125 125 125 125 125 125 125 125 125 125 125 125 125 125 125 125 125 125 125 125 125 125 125 125 125 125 125 125 125 
125 125 125 125 125 125 125 125 125 125 125 125 125 125 125 125 125 125 125 125 125 125 125 125 125 125 125 125 125 125 125 125 125 125 125 125 125 125 125 125 125 125 125 125 125 125 125 125 125 125 
125 125 125 125 125 125 125 125 125 125 125 125 125 125 125 125 125 125 125 125 125 125 125 125 125 125 125 125 125 125 125 125 125 125 125 125 125 125 125 125 125 125 125 125 125 125 125 125 125 125 
125 125 125 125 125 125 125 125 125 125 125 125 125 125 125 125 125 125 125 125 125 125 125 125 125 125 125 125 125 125 125 125 125 125 125 125 125 125 125 125 125 125 125 125 125 125 125 125 125 125 
125 125 125 125 125 125 125 125 125 125 125 125 125 125 125 125 125 125 125 125 125 125 125 133 128 128 128 132 125 125 125 125 125 125 125 125 133 128 128 128 128 132 125 125 125 125 125 125 125 125 
125 125 125 125 125 125 133 128 128 128 132 125 125 125 133 128 128 132 125 125 125 125 125 126 95 95 95 127 132 125 125 125 125 125 125 133 129 95 95 95 95 127 132 125 125 125 125 125 125 125 
125 125 125 125 125 125 126 95 95 95 127 128 128 128 129 95 95 127 128 128 128 128 128 129 95 96 96 95 127 128 128 128 128 128 128 129 95 95 96 96 96 95 127 132 125 125 125 125 125 125 
125 125 125 125 125 125 126 95 96 96 96 96 96 96 96 96 96 96 96 96 96 96 96 96 96 96 96 96 96 96 96 96 96 96 96 96 96 96 96 96 96 96 95 124 125 125 125 125 125 125 
128 132 125 125 125 125 126 95 96 96 96 96 96 96 96 96 96 96 96 96 96 96 96 96 96 96 96 96 96 96 96 96 96 96 96 96 96 96 96 96 96 96 95 124 125 125 125 125 125 125 
68 127 128 128 128 128 129 95 96 96 96 96 96 96 96 96 96 96 96 96 96 121 122 122 122 122 122 122 122 122 122 122 122 122 122 122 122 122 123 96 96 95 121 130 125 125 125 125 125 125 
104 104 104 104 104 104 104 104 104 96 96 96 96 96 96 121 122 122 122 122 122 130 120 133 128 128 128 128 128 128 128 128 128 128 128 132 120 125 126 96 96 121 130 125 125 125 125 125 125 125 
101 101 101 101 101 101 101 101 101 100 96 121 122 122 122 130 120 125 120 120 125 120 125 126 95 53 95 95 53 95 95 95 53 95 53 124 125 120 126 96 96 124 125 125 125 125 125 125 125 125 
98 98 98 98 98 98 98 99 101 103 96 127 128 128 128 128 128 128 128 128 128 128 128 129 95 121 122 122 122 122 122 122 122 123 53 127 128 128 129 96 96 124 125 125 125 125 125 125 125 125 
68 68 121 122 122 122 123 102 101 101 100 95 53 95 53 53 95 95 95 53 95 95 53 95 95 124 125 120 125 120 125 120 120 126 53 53 95 53 95 96 96 124 125 125 125 125 125 125 125 125 
68 121 130 125 125 125 126 95 98 98 96 121 122 122 122 122 122 122 122 122 122 122 122 122 122 130 133 128 128 128 128 128 128 129 95 121 122 122 123 96 96 124 125 125 125 125 125 125 125 125 
122 130 125 125 125 125 126 95 96 96 96 124 133 128 128 128 128 128 128 128 128 128 128 128 128 128 129 95 53 95 53 95 53 95 53 124 125 120 126 96 96 127 132 125 125 125 125 125 125 125 
125 125 125 125 125 125 131 123 95 96 96 124 126 53 95 95 95 53 95 95 95 95 95 53 53 95 53 95 121 122 122 122 122 122 122 130 120 133 129 96 96 95 124 125 125 125 125 125 125 125 
125 125 125 125 125 125 125 126 95 96 96 127 129 53 121 122 122 122 122 122 122 122 122 122 122 122 122 122 130 120 125 120 133 128 128 128 128 129 95 96 96 95 124 125 125 125 125 125 125 125 
125 125 125 125 125 125 125 131 123 96 96 53 95 95 127 128 128 128 128 128 128 128 128 128 128 128 128 128 128 128 128 128 129 95 95 95 95 95 95 96 96 96 127 132 125 125 125 125 125 125 
125 125 125 125 125 125 125 125 126 96 96 95 95 95 53 95 95 95 95 95 95 53 95 95 95 95 95 95 95 95 95 95 95 95 95 95 95 95 73 96 96 96 95 124 125 125 125 125 125 125 
125 125 125 125 125 125 125 133 129 96 96 95 95 95 95 95 95 53 53 95 95 95 95 95 53 53 95 95 53 95 95 95 95 80 121 123 95 95 66 96 96 96 95 124 125 125 125 125 125 125 
125 125 125 125 125 125 125 126 95 96 96 66 94 121 122 122 122 123 73 53 95 95 53 53 66 95 95 80 87 121 122 122 122 122 130 131 123 95 95 96 96 96 95 124 125 125 125 125 125 125 
125 125 125 125 125 125 125 126 95 96 96 87 121 130 120 125 120 131 123 66 94 121 123 87 59 121 122 122 122 130 133 128 128 132 125 120 126 95 95 96 96 96 95 124 125 125 125 125 125 125 
125 125 125 125 125 125 125 126 95 96 96 121 130 133 128 132 120 120 131 122 122 130 131 122 122 130 133 128 128 128 129 95 95 124 120 133 129 95 59 96 96 96 95 124 125 125 125 125 125 125 
125 125 125 125 125 125 125 131 123 96 96 127 128 129 68 127 128 128 132 120 125 120 133 128 128 128 129 95 95 95 53 95 121 130 133 129 95 95 87 96 96 95 121 130 125 125 125 125 125 125 
125 125 125 125 125 125 133 128 129 96 96 73 87 95 53 68 95 95 127 128 128 128 129 68 68 95 53 95 53 95 121 122 130 133 129 95 53 95 95 96 96 121 130 125 125 125 125 125 125 125 
125 125 125 125 125 125 126 95 96 96 96 95 53 95 95 95 53 95 95 95 95 53 53 53 53 95 53 94 59 121 130 133 128 129 53 53 121 123 95 96 96 124 125 125 125 125 125 125 125 125 
125 125 125 125 125 125 126 95 96 96 96 95 95 95 95 95 66 87 53 95 95 95 53 95 53 53 73 121 122 130 133 129 95 53 95 121 130 131 123 96 96 124 125 125 125 125 125 125 125 125 
125 125 125 125 125 125 126 95 96 96 96 66 95 121 122 122 122 122 122 122 122 122 122 122 122 122 122 130 120 133 129 53 53 95 121 130 120 120 126 96 96 124 125 125 125 125 125 125 125 125 
125 125 125 125 125 125 131 123 95 96 96 87 53 124 133 128 128 128 128 128 128 128 128 128 128 128 128 128 128 129 95 95 95 121 130 120 133 128 129 96 96 124 125 125 125 125 125 125 125 125 
125 125 125 125 125 125 125 126 95 96 96 95 95 127 129 95 53 95 53 95 53 95 95 95 53 95 53 95 95 95 53 121 122 130 120 133 129 95 95 96 96 124 125 125 125 125 125 125 125 125 
125 125 125 125 125 125 125 126 95 96 96 53 95 53 95 95 95 121 122 122 122 122 122 122 122 122 122 122 122 122 122 130 133 128 128 129 95 73 95 96 96 124 125 125 125 125 125 125 125 125 
125 125 125 125 125 125 125 126 95 96 96 95 87 121 122 122 122 130 133 128 128 128 128 128 128 128 128 128 128 128 128 128 129 95 95 95 55 53 80 96 96 127 132 125 125 125 125 125 125 125 
125 125 125 125 125 125 133 129 95 96 96 95 95 127 128 128 128 128 129 59 95 95 95 95 95 95 95 95 95 95 95 95 95 95 54 95 95 95 95 96 96 95 124 125 125 125 125 125 125 125 
125 125 125 125 125 125 126 95 96 96 96 59 55 95 95 95 95 95 95 54 73 80 53 53 95 55 95 53 53 95 95 95 53 95 95 55 95 53 95 96 96 95 124 125 125 125 125 125 125 125 
125 125 125 125 125 125 126 95 96 96 96 95 95 53 53 95 95 95 95 95 95 95 95 53 95 95 95 95 54 95 95 54 94 59 95 53 95 53 95 96 96 95 127 132 125 125 125 125 125 125 
125 125 125 125 125 125 131 123 95 96 96 95 95 95 95 95 55 95 95 95 95 95 95 95 95 95 95 95 53 53 95 95 80 95 95 95 95 54 95 96 96 96 95 124 125 125 125 125 125 125 
125 125 125 125 125 125 125 126 95 96 96 95 95 95 54 95 95 95 95 95 53 95 53 95 95 55 95 95 95 53 95 95 53 95 95 95 95 95 95 96 96 96 95 124 125 125 125 125 125 125 
125 125 125 125 125 125 133 129 95 96 96 95 95 95 95 95 95 95 95 53 95 95 95 53 95 53 95 53 95 53 54 95 95 55 53 95 54 95 95 96 96 96 95 124 125 125 125 125 125 125 
125 125 125 125 125 125 126 95 95 96 96 87 55 95 95 53 53 95 95 55 95 95 95 73 54 95 95 95 95 95 95 53 53 95 95 95 53 95 73 96 96 96 95 124 125 125 125 125 125 125 
125 125 125 125 125 133 129 95 96 96 96 80 73 95 95 95 95 95 95 95 54 95 94 95 59 95 95 95 55 95 54 95 95 95 95 95 95 94 87 96 96 96 95 124 125 125 125 125 125 125 
125 125 125 125 125 126 95 96 96 96 96 96 96 96 96 96 96 96 96 96 96 96 96 96 96 96 96 96 96 96 96 96 96 96 96 96 96 96 96 96 96 96 95 124 125 125 125 125 125 125 
125 125 125 125 125 126 95 96 96 96 96 96 96 96 96 96 96 96 96 96 96 96 96 96 96 96 96 96 96 96 96 96 96 96 96 96 96 96 96 96 96 95 121 130 125 125 125 125 125 125 
125 125 125 125 125 126 95 95 95 95 96 96 96 96 95 95 95 95 95 95 95 96 96 96 95 95 95 95 95 95 96 96 96 96 95 95 96 96 96 96 95 121 130 125 125 125 125 125 125 125 
125 125 125 125 125 131 122 122 123 95 95 95 95 95 95 95 95 95 121 122 123 95 95 95 121 122 122 122 122 123 95 96 96 95 121 123 95 95 95 95 121 130 125 125 125 125 125 125 125 125 
125 125 125 125 125 125 125 125 131 122 122 122 122 122 122 122 122 122 130 125 131 122 122 122 130 125 125 125 125 131 123 95 95 121 130 131 122 122 122 122 130 125 125 125 125 125 125 125 125 125 
125 125 125 125 125 125 125 125 125 125 125 125 125 125 125 125 125 125 125 125 125 125 125 125 125 125 125 125 125 125 131 122 122 130 125 125 125 125 125 125 125 125 125 125 125 125 125 125 125 125 
125 125 125 125 125 125 125 125 125 125 125 125 125 125 125 125 125 125 125 125 125 125 125 125 125 125 125 125 125 125 125 125 125 125 125 125 125 125 125 125 125 125 125 125 125 125 125 125 125 125 
125 125 125 125 125 125 125 125 125 125 125 125 125 125 125 125 125 125 125 125 125 125 125 125 125 125 125 125 125 125 125 125 125 125 125 125 125 125 125 125 125 125 125 125 125 125 125 125 125 125 
125 125 125 125 125 125 125 125 125 125 125 125 125 125 125 125 125 125 125 125 125 125 125 125 125 125 125 125 125 125 125 125 125 125 125 125 125 125 125 125 125 125 125 125 125 125 125 125 125 125 
