95 95 53 53 95 54 95 54 95 95 95 57 58 95 95 95 95 95 95 95 53 95 53 95 95 53 53 53 53 95 53 56 53 95 95 95 95 95 95 95 95 95 95 95 95 95 95 95 95 95 
95 95 54 95 53 95 54 54 95 95 95 58 58 95 95 95 53 53 95 95 95 95 95 53 95 95 57 95 95 95 95 95 95 95 53 95 53 58 56 95 95 95 95 95 95 95 95 95 95 95 
95 53 95 95 95 53 53 53 95 95 95 95 95 95 56 53 95 95 95 95 95 95 53 95 95 95 95 53 95 95 95 53 95 95 95 95 58 53 53 95 95 95 95 56 95 95 95 95 95 95 
57 53 95 95 57 57 95 95 95 95 95 95 95 95 95 56 95 53 53 53 96 96 96 96 95 96 58 95 58 53 58 95 95 56 95 95 53 58 53 96 96 96 96 56 53 95 95 53 95 95 
95 95 53 95 95 54 95 53 53 96 96 96 96 95 53 53 53 96 96 96 96 96 96 96 96 96 96 96 95 95 57 57 95 56 96 96 96 96 96 96 96 96 96 56 56 56 95 95 95 95 
53 95 95 53 54 53 55 95 96 96 96 96 96 96 96 96 96 96 96 96 96 96 96 96 96 96 96 96 96 96 96 96 96 96 96 96 96 96 96 96 96 96 96 96 95 56 95 95 95 95 
53 95 95 95 57 95 55 57 96 96 96 96 96 96 96 96 96 96 96 96 96 96 96 96 96 96 96 96 96 96 96 96 96 96 96 96 96 96 96 96 96 96 96 96 58 95 95 95 95 95 
95 95 57 57 95 54 53 96 96 96 96 96 96 96 96 96 96 96 96 96 96 96 96 96 96 96 96 96 96 96 96 96 96 96 96 96 96 96 96 96 96 96 96 96 95 53 95 95 95 95 
57 57 57 95 95 95 56 96 96 96 96 96 96 96 96 96 96 96 96 96 96 96 96 96 96 96 96 96 96 96 96 96 96 96 96 96 96 96 96 96 96 96 96 96 53 95 56 53 95 95 
95 95 95 95 95 55 56 96 96 96 96 114 108 108 108 108 108 115 53 54 54 95 54 95 95 95 53 54 53 54 54 54 54 54 53 53 54 95 96 96 96 96 96 96 95 53 95 95 95 95 
95 95 95 95 95 95 95 96 96 96 96 104 104 104 104 104 104 104 95 106 106 106 53 54 54 53 53 95 106 106 95 95 56 53 53 53 54 95 58 96 96 96 96 96 53 95 95 95 95 95 
95 95 95 56 95 95 95 95 96 96 96 101 101 101 101 101 101 101 100 55 53 53 56 54 95 95 95 54 53 95 53 53 106 106 95 95 95 54 53 96 96 96 96 96 56 53 95 54 95 95 
95 95 95 56 95 95 95 96 96 96 96 98 98 98 98 98 99 101 100 95 114 108 108 108 108 108 108 109 53 95 53 53 95 95 95 106 106 95 53 96 96 96 96 96 53 56 95 53 95 95 
95 95 95 95 95 55 95 96 96 96 96 114 108 108 109 95 102 101 103 104 104 104 104 104 95 106 106 112 106 106 95 95 54 53 95 54 95 95 95 96 96 96 96 53 53 53 95 53 95 95 
95 95 95 55 55 95 95 96 96 96 96 95 54 95 112 54 102 101 101 101 101 101 101 101 100 53 53 112 95 53 53 114 108 108 108 108 115 95 96 96 96 96 96 96 53 53 95 95 95 95 
95 95 95 95 95 95 55 96 96 96 96 96 54 54 117 54 53 98 98 98 98 98 99 101 103 95 53 117 95 95 95 95 53 54 95 54 53 95 96 96 96 96 96 96 95 53 95 95 95 95 
95 95 55 95 54 54 56 96 96 96 96 95 106 106 95 95 95 95 106 106 53 116 102 101 101 103 104 104 95 106 106 95 53 106 106 106 95 54 95 96 96 96 96 96 95 95 53 95 95 95 
95 95 95 55 54 95 96 96 96 96 96 95 56 54 95 95 114 108 108 108 108 113 95 99 101 101 101 101 100 95 53 54 95 95 95 53 114 108 115 96 96 96 96 96 56 95 95 53 53 95 
95 95 95 95 95 96 96 96 96 96 96 96 54 54 54 95 106 106 106 95 95 95 95 54 98 99 101 101 103 104 104 54 114 108 115 106 106 95 53 96 96 96 96 56 95 95 53 95 95 95 
95 95 95 95 95 96 96 96 96 96 96 96 54 95 95 95 95 95 54 95 54 106 106 53 95 102 101 101 101 101 101 103 104 104 104 104 104 104 104 96 96 96 96 95 95 95 53 95 95 95 
95 95 55 95 95 96 96 96 96 96 96 95 54 54 95 54 95 54 95 53 53 95 114 108 108 109 98 98 99 101 101 101 101 101 101 101 101 101 101 96 96 96 96 95 95 53 53 95 95 95 
95 95 55 95 95 95 96 96 96 96 96 53 54 106 106 95 95 95 95 56 54 95 95 106 106 117 53 54 105 101 97 98 98 98 98 98 98 98 98 96 96 96 96 56 53 95 53 95 95 95 
95 95 55 55 95 95 96 96 96 96 96 96 54 95 95 95 95 95 95 54 53 54 95 95 54 54 106 102 101 101 100 106 106 53 53 53 106 106 95 96 96 96 96 96 95 53 56 95 95 95 
95 95 95 95 95 95 95 96 96 96 96 96 54 95 54 95 54 106 106 54 53 95 53 53 95 95 95 105 101 97 53 53 53 54 95 53 54 54 95 96 96 96 96 96 95 95 95 95 95 95 
95 95 95 95 95 95 55 95 96 96 96 55 54 95 95 95 95 95 54 54 53 54 53 95 54 104 105 101 101 100 95 54 106 106 106 95 54 54 96 96 96 96 96 95 95 95 95 95 95 95 
95 95 95 95 95 95 95 95 96 96 96 96 54 54 54 54 54 54 95 95 95 56 53 53 102 101 101 97 98 95 95 54 95 95 95 53 106 106 96 96 96 96 96 96 95 95 95 95 95 95 
95 55 95 53 95 55 95 95 96 96 96 96 54 54 53 53 53 95 96 96 96 96 53 54 102 101 97 54 95 95 53 53 53 95 95 54 53 54 95 96 96 96 96 96 56 95 95 95 95 95 
95 95 95 95 95 95 55 96 96 96 96 96 96 96 96 96 96 96 96 96 96 96 96 54 102 101 100 96 96 96 96 95 95 53 54 96 96 54 96 96 96 96 96 96 53 95 95 95 95 95 
55 95 95 55 95 95 96 96 96 96 96 96 96 96 96 96 96 96 96 96 96 96 96 96 96 98 96 96 96 96 96 96 96 96 96 96 96 96 96 96 96 96 96 96 53 95 95 95 95 95 
55 95 95 95 95 96 96 96 96 96 96 96 96 96 96 96 96 96 96 96 96 96 96 96 96 95 96 96 96 96 96 96 96 96 96 96 96 96 96 96 96 96 96 96 96 95 95 95 95 95 
95 95 95 95 53 96 96 96 96 96 96 96 54 95 96 96 96 96 96 96 96 96 96 95 95 95 96 96 96 96 96 96 96 96 96 96 96 96 96 96 96 96 96 96 96 95 56 95 95 95 
95 95 95 56 53 53 96 96 96 96 96 95 54 54 95 96 96 96 96 53 96 96 96 95 96 96 96 96 96 96 96 96 96 96 96 96 96 96 96 96 96 96 96 95 53 56 95 95 95 95 
95 95 95 55 95 95 95 96 96 96 96 55 54 66 95 54 95 95 56 54 95 56 95 95 96 96 96 96 96 96 96 96 96 96 53 53 56 96 96 96 96 96 96 96 53 95 95 95 95 95 
95 56 95 55 95 95 95 96 96 96 96 55 95 95 56 54 54 95 95 53 87 56 54 53 95 54 54 54 95 95 54 54 95 54 54 53 53 54 96 96 96 96 96 96 96 95 95 95 95 95 
95 95 95 55 95 95 95 96 96 96 96 95 53 95 95 59 95 95 95 53 54 95 95 95 53 66 95 54 55 60 61 61 61 61 62 68 53 87 95 96 96 96 96 96 96 95 95 95 95 95 
95 95 95 95 55 55 95 96 96 96 96 53 53 60 61 61 62 95 54 95 73 54 53 95 87 95 95 56 54 67 95 95 53 95 69 95 68 53 53 96 96 96 96 96 96 95 95 95 95 95 
95 95 95 55 56 95 96 96 96 96 96 95 54 74 75 75 76 56 95 56 95 95 53 95 95 54 54 95 95 67 54 95 95 53 69 54 68 53 66 96 96 96 96 96 53 95 95 95 95 95 
95 95 95 95 55 95 96 96 96 96 96 55 54 81 82 82 83 53 95 95 95 95 53 56 53 95 53 94 53 74 75 75 75 75 76 68 68 54 95 96 96 96 96 96 54 54 95 95 95 95 
95 95 95 55 95 95 96 96 96 96 96 95 59 88 89 89 90 95 53 53 53 95 95 54 66 95 95 53 54 81 82 82 82 82 83 53 68 94 95 96 96 96 96 96 96 53 54 95 95 95 
95 95 95 95 95 55 96 96 96 96 96 96 54 54 53 87 53 66 53 53 73 54 53 53 53 59 95 95 95 81 82 82 82 82 83 68 53 54 87 96 96 96 96 96 96 95 53 95 95 95 
95 95 95 95 95 55 96 96 96 96 96 96 96 54 95 54 95 54 54 95 54 95 95 95 95 95 54 54 87 88 89 89 89 89 90 68 68 54 96 96 96 96 96 96 96 53 53 53 95 95 
95 95 95 95 95 55 96 96 96 96 96 96 96 96 96 96 96 96 96 96 96 96 96 96 96 96 96 96 96 53 95 54 95 95 95 53 53 96 96 96 96 96 96 96 95 95 95 95 95 95 
95 95 95 95 95 95 96 96 96 96 96 96 96 96 96 96 96 96 96 96 96 96 96 96 96 96 96 96 96 96 96 53 53 54 96 96 96 96 96 96 96 96 96 96 56 53 53 95 95 95 
95 95 95 95 95 95 96 96 96 96 96 96 96 96 96 96 96 96 96 96 96 96 96 96 96 96 96 96 96 96 96 96 96 96 96 96 96 96 96 96 96 96 96 96 95 95 95 95 95 95 
95 95 95 95 95 95 96 96 96 96 96 96 96 96 96 96 96 96 96 96 96 96 96 96 96 96 96 96 96 96 96 96 96 96 96 96 96 96 96 96 96 96 96 96 95 95 95 95 95 95 
95 95 95 55 55 55 95 95 96 96 96 96 96 96 96 96 96 96 96 96 53 96 96 96 96 96 54 55 54 96 96 96 96 95 95 54 96 96 96 96 96 95 56 95 95 95 95 95 95 95 
95 95 95 95 95 55 95 95 96 96 96 96 96 96 96 96 53 96 53 95 95 95 95 96 95 54 54 56 55 96 96 53 95 54 95 95 95 95 95 95 95 56 56 95 54 95 95 95 95 95 
95 95 95 95 95 55 95 95 95 95 95 96 96 96 96 55 95 95 95 95 95 95 95 95 95 95 95 95 95 95 95 54 54 54 95 95 95 95 95 95 95 95 95 95 95 53 95 56 95 95 
95 95 95 95 95 95 95 95 95 95 95 55 55 95 95 95 55 95 55 55 55 95 95 95 54 95 95 95 95 95 54 95 95 95 95 95 95 53 95 95 95 53 95 95 95 95 95 56 95 95 
95 95 95 95 95 95 95 95 95 95 95 95 95 95 95 95 95 95 95 95 95 95 95 95 95 95 95 95 95 95 95 95 95 95 95 95 95 95 95 95 95 56 95 95 56 54 95 95 95 95 
