0 0 0 0 0 0 0 0 0 0 0 0 0 0 0 0 0 0 0 0 0 0 0 0 81 0 83 0 81 0 113 0 0 113 80 0 82 83 0 113 0 81 0 0 0 0 71 70 70 69 83 0 0 81 113 0 83 0 83 80 0 0 0 83 0 81 0 83 0 0 81 0 0 0 0 0 0 0 0 0 0 0 0 0 0 0 0 0 0 0 0 0 0 0 0 0 0 0 0 0 
0 0 0 0 0 0 0 0 0 0 0 0 0 0 0 0 0 0 0 0 0 0 0 0 82 0 82 0 0 82 0 0 83 113 0 0 113 0 113 0 82 81 0 83 0 83 71 70 70 69 0 83 0 81 83 0 113 0 0 0 113 80 0 0 83 0 0 0 81 0 0 83 0 0 0 0 0 0 0 0 0 0 0 0 0 0 0 0 0 0 0 0 0 0 0 0 0 0 0 0 
0 0 0 0 0 0 0 0 0 0 0 0 0 0 0 0 0 0 0 0 0 0 0 0 83 81 83 0 81 0 113 0 0 113 82 0 0 82 113 80 0 81 0 0 0 0 71 70 70 69 0 0 0 81 0 0 80 0 113 0 83 0 113 0 0 81 0 0 0 0 81 0 0 0 0 0 0 0 0 0 0 0 0 0 0 0 0 0 0 0 0 0 0 0 0 0 0 0 0 0 
0 0 0 0 0 0 0 0 0 0 0 0 0 0 0 0 0 0 0 0 0 0 0 0 0 0 0 0 82 0 0 82 0 0 0 0 80 0 0 0 113 81 82 0 0 0 71 70 70 69 0 0 83 81 113 80 0 83 83 0 0 0 0 0 0 0 83 0 81 83 0 83 0 0 0 0 0 0 0 0 0 0 0 0 0 0 0 0 0 0 0 0 0 0 0 0 0 0 0 0 
0 0 0 0 0 0 0 0 0 0 0 0 0 0 0 0 0 0 0 0 0 0 0 0 0 83 0 81 0 83 0 0 83 0 83 0 0 82 83 113 0 81 0 83 0 0 71 70 70 69 0 0 0 81 0 0 0 83 80 0 113 113 0 83 0 81 0 0 0 0 0 0 0 0 0 0 0 0 0 0 0 0 0 0 0 0 0 0 0 0 0 0 0 0 0 0 0 0 0 0 
0 0 0 0 0 0 0 0 0 0 0 0 0 0 0 0 0 0 0 0 0 0 0 0 81 0 0 83 0 81 0 113 0 80 0 113 113 0 0 113 0 81 0 0 0 0 71 70 70 69 83 83 0 81 83 83 0 113 0 80 0 0 80 0 0 83 0 81 0 0 81 0 0 0 0 0 0 0 0 0 0 0 0 0 0 0 0 0 0 0 0 0 0 0 0 0 0 0 0 0 
0 0 0 0 0 0 0 0 0 0 0 0 0 0 0 0 0 0 0 0 0 0 0 0 83 0 81 0 82 0 0 113 83 0 0 0 0 0 80 113 0 81 83 0 82 0 71 70 70 69 0 0 82 81 0 0 0 0 0 0 113 0 113 83 0 81 0 0 0 0 83 0 0 0 0 0 0 0 0 0 0 0 0 0 0 0 0 0 0 0 0 0 0 0 0 0 0 0 0 0 
0 0 0 0 0 0 0 0 0 0 0 0 0 0 0 0 0 0 0 0 0 0 0 0 0 0 0 0 0 0 81 0 0 113 0 83 82 0 83 0 0 113 0 0 0 0 71 70 70 69 0 83 0 113 0 113 113 0 83 0 0 113 0 0 0 0 83 0 83 0 83 0 0 0 0 0 0 0 0 0 0 0 0 0 0 0 0 0 0 0 0 0 0 0 0 0 0 0 0 0 
0 81 0 113 0 0 0 113 0 0 0 0 0 81 0 0 0 0 0 81 113 0 0 113 81 82 0 113 83 0 0 82 83 80 80 82 0 80 83 0 113 82 113 113 0 82 71 70 70 69 0 0 81 0 0 82 0 80 0 81 0 0 0 83 81 0 80 0 113 0 80 0 0 113 0 113 80 0 80 0 0 80 0 81 0 80 18 18 113 18 18 18 80 0 80 0 0 80 113 113 
80 0 0 0 0 81 0 0 0 113 0 80 0 0 80 0 113 0 0 0 0 0 0 0 0 80 0 0 0 113 0 81 0 0 0 113 0 0 81 0 0 0 0 82 81 0 71 70 70 69 113 0 113 0 81 0 80 82 0 0 0 80 0 0 0 0 113 0 81 0 0 0 81 0 80 113 0 0 0 113 81 0 80 0 80 0 80 18 0 80 18 113 18 113 18 113 80 0 18 18 
0 113 0 0 0 0 80 0 0 0 113 0 0 113 80 0 0 0 113 0 80 0 81 0 0 0 0 80 0 0 0 0 0 113 81 0 80 0 0 0 82 0 82 81 0 0 71 70 70 69 99 113 82 82 0 81 0 81 0 0 0 113 0 81 0 81 0 80 0 113 0 80 0 0 113 0 0 81 0 0 113 0 18 18 0 113 0 18 81 18 113 18 0 80 18 18 18 113 18 81 
62 113 0 81 113 0 0 81 0 81 0 0 0 0 0 113 0 0 113 0 0 0 0 81 81 0 0 0 0 0 113 0 0 0 0 0 0 0 81 82 0 80 82 0 113 5 18 55 55 18 17 0 82 113 0 0 0 0 80 0 81 0 80 0 81 0 0 113 0 81 113 0 0 113 81 0 80 0 113 0 0 113 80 113 80 0 81 18 18 80 0 18 80 18 18 113 18 81 18 81 
62 113 0 0 0 80 0 0 113 0 0 80 0 81 0 0 0 0 0 80 0 0 0 0 0 0 0 0 0 0 0 0 0 80 0 80 0 113 0 0 113 0 0 0 81 19 18 18 0 0 17 0 0 0 0 113 113 0 80 0 0 0 0 0 80 0 113 0 0 113 0 80 0 81 0 113 0 113 0 0 80 0 18 18 0 0 113 18 113 0 0 113 113 80 0 113 80 0 18 18 
62 81 0 81 0 0 0 0 0 113 0 113 0 0 0 80 113 0 0 0 0 113 0 80 0 113 0 0 81 0 80 0 0 0 113 0 0 0 0 113 0 0 81 0 0 19 82 6 7 82 17 81 82 80 0 0 81 0 0 81 0 80 0 0 0 0 0 81 81 0 113 0 113 0 0 0 0 81 81 81 113 0 80 0 81 0 80 18 0 113 81 0 0 0 0 0 0 113 81 80 
62 0 0 113 0 80 0 0 81 0 0 0 0 81 0 0 0 0 0 81 0 0 0 0 0 0 0 81 0 0 0 0 113 81 0 80 0 81 0 82 0 0 0 2 3 34 18 21 22 63 17 0 82 113 0 82 80 82 0 0 0 0 0 113 0 81 80 0 80 0 81 113 0 80 0 81 0 0 0 81 0 113 18 113 0 18 18 113 0 0 0 80 0 113 113 0 81 0 81 18 
62 81 0 0 0 0 81 0 0 0 80 0 80 0 80 80 0 0 0 0 0 80 80 0 80 0 113 81 0 113 113 81 0 81 81 0 0 0 80 82 80 113 82 114 82 82 82 36 37 82 32 4 113 0 81 0 113 0 81 113 81 0 113 0 81 0 0 81 113 113 113 0 113 0 0 113 113 0 81 0 113 113 80 0 81 80 0 81 0 81 0 113 0 81 0 113 0 0 80 18 
62 80 113 81 113 80 28 81 113 80 113 81 80 28 113 113 81 80 113 80 113 80 0 113 0 113 0 0 81 0 0 113 81 113 113 113 80 113 0 0 81 0 113 113 113 81 0 82 0 81 113 20 0 113 0 113 0 113 113 0 0 80 0 113 0 113 80 0 0 80 0 113 0 81 113 0 0 113 0 113 0 81 81 113 0 0 80 18 113 0 81 0 113 0 113 18 80 113 18 113 
77 78 77 78 78 78 78 78 78 78 78 78 78 78 78 78 78 78 78 78 78 78 78 78 78 78 78 78 78 78 78 78 78 78 78 78 78 78 78 78 78 78 78 78 78 78 78 78 78 78 78 78 78 78 78 78 78 78 78 78 78 78 78 78 78 78 78 78 78 78 78 78 78 78 78 78 78 78 78 78 78 78 78 78 78 78 78 78 78 78 78 78 78 78 78 78 78 78 78 78 
107 108 108 108 108 108 108 108 108 108 108 108 108 108 108 108 108 108 108 108 108 108 108 108 108 108 108 108 108 108 108 108 108 108 108 108 108 108 108 108 108 108 108 108 108 108 108 108 108 108 108 108 108 108 108 108 108 108 108 108 108 108 108 108 108 108 108 108 108 108 108 108 108 108 108 108 108 108 108 108 108 108 108 108 108 108 108 108 108 108 108 108 108 108 108 108 108 108 108 108 
43 31 18 18 18 18 18 18 18 18 80 81 113 81 113 81 80 0 2 3 3 3 3 3 3 3 35 18 0 0 83 0 0 81 0 82 80 18 0 0 0 0 0 82 0 83 0 82 0 0 0 18 30 43 43 43 43 43 43 43 43 43 43 43 43 43 43 43 43 43 43 43 43 43 43 43 43 43 43 43 43 43 43 43 43 81 83 0 80 0 113 0 0 80 0 0 83 0 80 0 
15 42 43 43 43 43 43 43 43 43 43 43 43 43 43 43 31 0 17 113 82 6 7 113 113 0 83 0 0 0 0 0 83 0 0 0 0 83 0 0 81 0 82 83 0 0 0 0 0 81 82 18 45 13 13 13 13 13 13 13 13 13 13 13 13 13 13 13 13 13 13 13 13 13 13 13 13 13 13 13 13 13 13 13 13 113 81 0 83 0 80 0 83 0 0 113 0 0 0 113 
16 16 15 16 16 16 16 16 16 15 15 16 16 16 16 15 27 0 17 0 83 21 22 0 85 85 85 85 0 99 0 0 0 0 0 83 0 18 0 0 0 0 0 0 0 0 0 83 0 0 0 0 47 48 48 48 48 48 48 48 48 48 48 48 48 48 48 48 48 48 48 48 48 48 48 48 48 48 48 48 48 48 49 18 18 113 18 18 81 18 18 113 18 81 18 18 81 18 18 18 
16 16 15 16 16 16 15 16 15 16 16 16 16 16 16 16 27 0 17 82 81 36 37 71 70 70 70 70 69 32 33 33 33 33 33 33 33 33 33 33 33 33 33 33 33 4 0 82 0 0 0 0 62 0 81 0 80 0 81 0 0 0 0 0 82 2 33 33 33 33 33 33 33 33 33 33 33 33 33 33 4 0 64 0 0 81 0 113 0 113 0 81 0 0 0 0 0 113 0 0 
15 16 16 16 16 16 16 16 16 16 16 16 16 16 16 16 27 0 17 113 0 0 0 81 55 55 56 70 84 85 85 85 85 85 85 85 85 85 85 85 85 85 85 85 18 20 18 18 0 0 82 0 62 81 0 65 0 65 0 80 65 83 0 80 0 81 80 18 18 18 83 18 0 0 0 18 18 65 0 0 19 0 64 0 0 0 81 0 83 83 0 0 0 83 83 83 0 0 0 113 
16 16 16 16 16 16 16 16 16 16 16 16 16 16 16 16 27 0 17 83 82 113 0 83 0 0 71 70 70 70 70 70 70 70 70 70 70 70 70 70 70 70 70 70 84 18 18 18 18 80 83 0 62 80 0 0 83 0 0 0 0 81 0 65 18 18 18 18 65 18 18 65 18 83 0 6 7 0 65 0 19 0 64 0 0 0 113 80 0 0 0 80 0 0 113 0 0 81 0 0 
16 16 16 16 16 15 16 16 16 16 16 16 16 15 16 16 27 0 0 33 35 0 81 0 0 80 0 56 70 70 70 70 70 70 70 70 70 70 70 70 70 70 70 70 70 69 82 0 18 0 0 18 62 81 0 83 0 0 0 0 83 0 80 18 18 65 18 18 18 18 18 18 18 0 0 21 22 0 80 0 19 0 64 0 0 81 0 113 83 0 83 113 0 0 0 0 80 0 0 113 
16 16 15 16 16 16 16 16 15 16 16 15 16 16 16 16 27 81 0 65 0 82 0 0 0 0 99 0 55 55 55 55 55 55 55 56 70 54 55 55 55 55 56 70 70 69 18 83 18 0 83 18 62 18 65 0 0 0 0 83 18 18 18 0 0 0 0 0 80 0 0 83 0 0 0 36 37 0 0 65 19 0 64 0 0 0 81 0 80 113 113 0 80 0 113 0 0 113 80 0 
16 16 16 16 16 16 16 16 16 16 16 16 16 16 16 16 27 82 0 0 0 82 0 65 65 0 32 3 3 33 33 33 81 33 81 71 70 69 81 33 33 4 71 70 70 69 65 18 18 0 81 18 62 81 0 18 0 18 83 0 0 0 83 0 0 80 85 85 85 85 85 85 85 0 82 0 0 0 0 0 19 0 64 0 0 81 0 0 80 0 83 0 0 0 0 0 83 0 0 0 
16 16 16 16 16 16 16 16 16 16 16 16 16 16 16 16 27 18 82 0 81 0 65 65 18 0 81 0 0 18 0 0 0 83 0 71 70 69 0 82 81 20 71 70 70 69 65 18 18 0 0 18 62 65 0 0 18 18 82 0 85 85 85 85 85 86 70 70 70 70 70 70 70 69 82 83 18 18 80 0 19 0 64 0 0 0 81 0 83 0 0 0 81 0 113 0 0 0 80 0 
16 16 15 16 16 16 15 16 16 16 16 16 16 16 16 16 27 0 18 65 65 65 65 0 30 43 43 43 43 43 43 43 31 0 0 71 70 69 0 0 83 83 71 70 70 69 65 18 18 82 82 18 62 65 0 0 0 18 0 71 70 70 70 70 70 70 70 70 54 55 55 55 55 0 18 18 18 83 0 65 19 0 64 0 0 113 0 0 80 0 80 113 0 83 0 0 81 83 0 0 
16 16 16 16 16 16 16 16 15 16 16 16 16 16 16 16 27 0 82 65 65 0 0 30 44 12 13 13 13 13 14 15 42 31 0 71 70 69 83 0 0 83 71 70 70 69 113 113 113 99 82 82 62 65 0 85 85 85 85 86 70 70 70 70 70 70 54 55 82 0 80 0 82 80 0 6 7 0 80 0 19 0 64 0 0 0 81 0 0 113 0 0 0 0 113 80 0 0 0 0 
16 16 16 16 16 16 16 16 16 16 16 16 16 16 16 16 27 82 0 65 65 0 83 29 16 27 81 18 82 82 29 15 16 27 0 71 70 69 0 0 65 99 71 70 70 84 85 85 85 32 33 35 62 18 71 70 70 70 70 70 70 70 54 55 55 55 80 18 18 65 65 65 65 65 65 21 22 18 65 0 19 0 64 0 0 81 0 113 0 0 83 0 80 0 0 80 0 0 80 0 
16 16 16 16 16 15 16 15 16 16 16 16 16 16 16 16 27 0 0 65 65 83 0 29 15 27 82 6 7 83 29 16 15 27 18 71 70 69 0 82 65 17 71 70 70 70 70 70 70 122 124 124 124 127 70 70 70 54 55 55 55 55 18 82 80 0 82 65 65 65 65 65 65 65 65 36 37 81 33 33 34 0 64 0 0 0 81 0 80 113 80 0 0 83 0 0 0 83 0 0 
16 15 16 16 16 16 16 16 16 16 16 16 16 16 16 16 27 82 0 65 65 0 0 29 16 27 82 21 22 122 124 124 124 125 127 71 70 69 81 0 65 17 18 55 55 55 55 55 55 2 33 4 62 65 65 65 65 65 65 65 65 65 0 65 65 65 65 65 65 65 65 65 65 65 65 0 0 0 0 0 0 0 64 0 0 113 0 83 0 0 0 113 0 113 0 113 0 0 113 0 
16 16 16 15 16 16 16 16 16 16 16 16 15 16 16 16 27 0 82 65 65 0 83 29 16 27 82 36 37 18 29 130 130 27 18 18 55 18 5 0 0 32 33 33 3 3 35 81 81 114 18 18 77 78 78 78 78 78 78 78 78 78 8 78 78 78 78 78 78 78 78 78 78 78 78 78 78 78 78 78 78 78 79 0 0 0 113 0 0 80 0 83 0 0 0 0 0 83 0 0 
16 16 16 16 16 15 16 16 16 16 16 16 16 16 16 16 27 18 18 113 81 18 0 29 15 42 43 43 43 43 44 15 15 27 81 33 33 33 34 0 83 82 0 0 0 0 83 0 0 80 83 113 92 93 93 93 93 93 93 93 93 93 23 93 93 93 93 93 93 93 93 93 93 93 93 93 93 93 93 93 93 93 94 0 0 81 0 0 81 83 0 0 83 80 0 81 83 0 80 0 
16 16 16 16 16 16 16 16 16 16 16 16 16 16 16 16 27 82 83 113 65 0 0 29 16 16 15 15 16 15 16 16 12 46 0 18 18 18 0 0 0 80 0 0 0 0 83 0 0 0 82 113 92 93 93 93 93 93 93 93 93 93 23 93 93 93 93 93 93 93 93 93 93 93 93 93 93 93 93 93 93 93 93 0 0 0 113 0 113 0 0 0 0 0 80 0 0 0 81 0 
16 16 16 16 16 16 15 16 16 15 16 16 16 16 15 16 27 18 0 113 65 83 82 45 13 13 13 13 13 13 13 13 46 18 18 0 18 81 0 83 0 0 83 0 0 0 0 0 80 0 82 113 92 93 93 93 93 93 93 93 93 93 23 93 93 93 93 93 93 93 93 93 93 93 93 93 93 93 93 93 93 93 93 0 0 0 81 0 0 83 0 81 0 0 0 81 0 0 83 0 
16 16 15 16 16 16 16 16 16 16 16 16 16 16 16 16 27 18 18 113 65 18 18 83 18 18 18 83 18 80 18 18 18 18 83 18 18 18 18 0 0 0 0 0 0 81 0 0 0 0 113 113 92 93 93 93 93 93 93 93 93 93 23 93 93 93 93 93 93 93 93 93 93 93 93 93 93 93 93 93 93 94 94 0 0 81 0 0 0 80 0 0 0 0 83 81 0 113 0 0 
16 16 16 16 16 16 15 16 16 16 16 15 15 16 16 16 27 0 82 113 65 80 0 83 18 81 0 0 0 0 81 0 18 83 18 0 81 18 82 0 0 80 0 0 82 0 0 113 113 113 113 113 107 108 108 108 108 108 108 108 108 108 38 108 108 108 108 108 108 108 108 108 108 108 108 108 108 108 108 108 108 108 109 0 0 0 113 0 113 0 0 83 80 0 0 0 0 0 0 80 
16 16 16 16 16 16 16 16 15 16 16 16 16 16 16 16 27 83 0 113 113 0 18 82 0 0 0 0 83 63 0 0 0 0 0 0 0 0 0 0 0 0 0 0 0 113 113 113 113 0 0 83 18 0 0 0 0 0 0 0 0 0 18 18 18 18 0 0 0 0 0 0 0 0 0 0 0 0 0 0 0 0 0 0 0 0 81 0 0 0 0 0 81 83 0 0 0 113 0 0 
16 16 15 16 16 16 16 16 16 16 16 16 16 16 16 16 27 83 63 113 113 113 113 113 113 113 113 113 113 113 113 113 113 113 113 113 113 113 113 113 113 113 113 113 113 113 113 83 0 18 113 113 0 0 0 0 0 0 0 0 0 18 18 18 18 18 0 0 0 0 0 0 0 0 0 0 0 0 0 0 0 0 0 0 0 81 0 83 0 81 83 0 0 0 0 0 83 0 0 0 
16 16 16 16 16 15 16 16 15 16 16 16 16 15 16 15 27 0 18 83 18 18 18 82 18 83 18 82 82 82 82 18 18 18 18 82 83 0 83 0 82 83 0 18 83 0 0 83 113 113 113 98 18 18 0 0 18 18 18 18 18 18 18 18 0 0 0 0 0 0 0 0 0 0 0 0 18 18 18 18 18 18 0 0 0 81 0 0 0 0 0 0 0 80 0 0 0 0 81 0 
16 16 16 16 16 16 16 16 16 16 16 16 16 16 16 16 27 113 113 113 113 113 113 113 113 113 113 113 113 113 113 113 113 113 113 113 113 113 113 113 113 113 113 113 113 113 113 113 113 0 0 98 18 0 0 0 0 18 18 18 18 0 18 18 18 18 18 18 18 18 18 18 18 18 18 18 0 18 18 18 18 18 18 0 0 0 81 0 113 0 80 0 0 0 0 113 0 80 0 0 
16 16 15 16 16 16 15 16 16 16 15 16 15 16 16 15 27 0 0 0 0 0 0 0 0 0 0 0 0 0 0 0 0 0 0 0 0 0 18 18 18 18 18 0 0 0 0 0 0 0 0 98 0 0 0 0 0 0 18 0 0 0 0 0 0 0 0 0 0 0 0 0 0 0 0 0 0 0 0 0 0 0 0 0 0 113 0 0 0 0 0 81 81 0 0 83 0 113 0 0 
16 16 16 16 16 16 16 16 16 16 16 16 16 16 16 16 27 0 0 0 0 0 0 0 0 0 0 0 0 0 0 0 0 0 0 0 0 0 0 0 0 0 0 0 0 0 0 0 0 0 0 98 0 0 0 0 0 0 0 0 0 0 0 0 0 0 0 0 0 0 0 0 0 0 0 0 0 0 0 0 0 0 0 0 0 81 113 81 113 83 0 0 81 0 113 0 0 81 0 0 
15 16 16 16 16 15 16 16 16 16 16 15 16 16 16 16 27 0 0 0 0 0 0 0 0 0 0 0 0 0 0 0 0 0 0 0 0 0 0 0 0 0 0 0 0 0 0 0 0 0 0 98 98 0 0 0 0 0 0 0 0 0 0 0 0 0 0 0 0 0 0 0 0 0 0 0 0 0 0 0 0 0 0 0 0 0 0 113 0 0 0 0 83 0 0 0 0 83 0 0 
16 16 16 16 16 16 16 16 16 15 16 16 16 16 15 16 27 0 0 0 0 0 0 0 0 0 0 0 0 0 0 0 0 0 0 0 0 0 0 0 0 0 0 0 0 0 0 0 0 0 0 98 0 98 0 0 0 0 0 0 0 0 0 0 0 0 0 0 0 0 0 0 0 0 0 0 0 0 0 0 0 0 0 0 0 0 81 0 83 0 81 0 0 80 0 80 0 0 0 113 
16 16 15 16 16 15 16 16 16 15 16 16 16 16 16 16 27 0 0 0 0 0 0 0 0 0 0 0 0 0 0 0 0 0 0 0 0 0 0 0 0 0 0 0 0 0 0 0 0 0 0 0 98 0 0 0 0 0 0 0 0 2 35 0 81 3 33 33 33 33 33 33 33 33 33 4 0 0 0 0 0 0 0 0 0 81 83 0 80 0 0 0 113 0 81 0 0 81 0 0 
16 16 16 16 16 15 16 16 16 16 15 15 15 16 16 16 27 0 0 0 0 0 0 0 0 0 0 0 0 0 0 0 0 0 0 0 0 0 0 0 0 0 0 0 0 0 0 0 0 0 0 0 98 98 0 0 0 0 0 0 0 17 0 0 0 0 0 0 0 0 0 0 0 0 0 19 0 0 0 0 0 0 0 0 0 81 81 0 0 0 80 0 0 0 80 0 0 0 113 0 
16 15 16 16 15 16 16 16 16 16 16 16 16 16 15 16 27 0 0 0 0 0 0 0 0 0 0 0 0 0 0 0 0 0 0 0 0 0 0 0 0 0 0 0 0 0 0 0 0 0 0 0 98 0 0 0 0 0 0 0 0 17 0 0 0 0 0 0 0 0 0 0 0 0 0 19 0 0 0 0 0 0 0 0 0 0 113 0 113 81 0 0 81 0 0 0 81 0 0 0 
16 16 16 16 16 16 15 16 16 15 16 16 16 16 16 16 27 0 0 0 0 0 0 0 0 0 0 0 0 0 0 0 0 0 0 0 0 0 0 0 0 0 0 0 0 0 0 0 0 0 0 98 0 0 0 0 0 0 0 0 0 99 0 0 0 0 0 0 0 0 0 0 18 0 0 19 0 0 0 0 0 0 0 0 0 81 0 83 0 0 0 0 83 0 83 0 0 0 0 113 
16 16 15 16 16 16 15 16 16 15 16 16 16 16 15 16 27 0 0 0 0 0 0 0 0 0 0 0 0 0 0 0 0 0 0 0 0 0 0 0 0 0 0 0 0 0 0 0 0 0 0 98 0 98 0 0 0 0 0 0 0 17 0 0 0 0 0 0 0 0 18 18 18 0 0 19 0 0 0 0 0 0 0 0 0 0 81 83 0 0 113 0 0 0 80 0 0 81 0 0 
15 16 16 16 16 16 16 15 16 16 16 16 16 16 16 15 27 0 0 0 0 0 0 0 0 0 0 0 0 0 0 0 0 0 0 0 0 0 0 0 0 0 0 0 0 0 0 0 0 0 0 0 98 98 0 0 0 0 0 0 0 17 0 0 0 0 0 0 81 18 18 63 18 63 0 19 0 0 0 0 0 0 0 0 0 0 0 113 80 0 0 0 81 0 0 0 0 0 0 83 
16 16 15 16 16 16 16 16 16 16 16 15 16 16 16 15 27 0 0 0 0 0 0 0 0 0 0 0 0 0 0 0 0 0 0 0 0 0 0 0 0 0 0 0 0 0 0 0 0 0 0 0 98 98 0 0 0 0 0 0 0 17 0 0 0 0 0 0 18 18 18 18 18 63 0 19 0 0 0 0 0 0 0 0 113 0 81 0 0 0 113 0 0 0 83 113 0 80 0 0 
15 15 16 16 16 15 16 16 16 15 16 16 16 15 16 15 27 0 0 0 0 0 0 0 0 0 0 0 0 0 0 0 0 0 0 0 0 0 0 0 0 0 0 0 0 0 0 0 0 0 0 98 98 0 0 0 0 0 0 0 0 17 0 0 0 0 0 0 0 18 18 18 63 0 0 19 0 0 0 0 0 0 0 0 0 81 0 113 83 0 0 0 113 0 83 0 0 83 0 0 
16 16 15 16 16 16 16 16 16 16 16 16 16 16 16 15 27 0 0 0 0 0 0 0 0 0 0 0 0 0 0 0 0 0 0 0 0 0 0 0 0 0 0 0 0 0 0 0 0 0 0 0 98 0 0 0 0 0 0 0 0 17 0 0 0 0 0 0 0 0 18 0 63 0 0 19 0 0 0 0 0 0 0 0 0 0 81 83 0 0 81 0 0 0 0 0 113 0 81 0 
16 16 16 16 16 16 16 16 15 16 16 16 16 16 16 15 27 0 0 0 0 0 0 0 0 0 0 0 0 0 0 0 0 0 0 0 0 0 0 0 0 0 0 0 0 0 0 0 0 0 0 0 0 0 0 0 0 0 0 0 0 17 0 0 0 0 0 0 0 0 0 0 63 63 0 19 0 0 0 0 0 0 0 0 0 113 0 113 0 0 80 0 83 0 81 0 0 0 0 0 
16 15 16 16 16 15 16 16 16 16 16 15 16 16 16 16 27 0 0 0 0 0 0 0 0 0 0 0 0 0 0 0 0 0 0 0 0 0 0 0 18 18 0 0 0 0 0 0 0 0 0 98 98 0 0 0 0 0 0 0 0 17 0 0 0 0 0 0 0 0 0 0 0 0 0 19 0 0 0 0 0 0 0 0 0 81 80 0 113 83 0 0 0 113 0 0 0 80 0 0 
16 16 16 16 16 16 16 16 16 16 16 16 16 16 16 16 27 0 0 0 0 0 0 0 0 0 0 0 0 0 0 0 0 0 0 0 0 0 0 0 0 18 18 0 0 0 0 0 0 0 0 98 98 0 0 0 0 0 0 0 0 32 33 33 33 33 33 33 33 33 33 33 33 33 33 34 0 0 0 0 0 0 0 0 0 0 81 0 0 0 81 0 0 0 0 83 0 0 81 0 
16 16 15 16 16 16 16 16 15 16 16 16 16 16 15 16 27 0 0 18 18 18 18 18 0 18 0 0 18 0 0 0 18 18 18 18 18 18 18 18 18 18 18 18 0 0 0 0 0 0 0 0 98 0 0 0 0 0 0 0 0 0 0 0 0 0 0 0 0 0 0 0 0 0 0 0 0 0 0 0 0 0 0 0 0 0 113 0 83 0 80 0 0 113 0 0 0 0 0 0 
16 15 15 16 16 16 16 16 16 16 16 16 16 16 15 15 27 0 18 18 18 18 18 18 18 18 18 18 18 18 18 18 18 18 18 18 18 18 18 18 0 18 18 0 18 0 0 0 0 0 0 98 0 0 0 0 0 0 0 0 0 0 0 0 0 0 0 0 0 0 0 0 0 0 0 0 0 0 0 0 0 0 0 0 0 81 0 0 113 0 0 0 113 0 83 0 80 0 113 0 
16 16 16 16 15 15 16 16 16 16 16 16 15 16 16 15 27 0 18 18 18 18 18 18 18 18 0 18 18 18 18 18 0 18 18 0 18 18 18 18 18 18 18 18 18 0 0 0 0 0 0 98 98 0 0 0 0 0 0 0 0 0 0 0 0 0 0 0 0 0 0 0 0 0 0 0 0 0 0 0 0 0 0 0 0 0 81 0 0 0 81 0 0 81 0 0 0 83 0 0 
15 16 16 16 16 16 16 16 15 15 16 15 15 16 16 15 27 0 0 0 0 18 18 18 18 18 18 18 18 18 18 18 0 18 0 0 0 0 0 0 0 0 0 0 0 0 0 0 0 0 0 0 98 0 0 0 0 0 0 0 0 0 0 0 0 0 0 0 0 0 0 0 0 0 0 0 0 0 0 0 0 0 0 0 0 81 0 0 83 0 83 0 113 0 0 80 0 0 0 0 
15 16 16 16 16 16 16 16 16 16 16 16 16 16 16 15 27 0 0 0 0 0 0 0 0 0 0 0 0 0 0 0 0 0 0 0 0 0 0 0 0 0 0 18 0 18 0 0 0 0 0 98 98 0 0 0 0 0 0 0 0 0 0 0 0 0 0 0 0 0 0 0 0 0 0 0 0 0 0 0 0 0 0 0 0 0 113 0 80 0 0 0 0 81 0 0 0 0 81 0 
16 16 16 15 15 16 16 16 16 15 16 16 16 16 16 16 27 0 0 0 0 0 0 0 0 0 0 0 0 0 0 0 0 0 0 0 0 0 0 0 0 0 0 0 18 0 18 0 0 0 0 0 98 0 0 0 0 0 0 0 0 0 0 0 0 0 0 0 0 0 0 0 0 0 0 0 0 0 0 0 0 0 0 0 0 0 81 0 0 83 0 113 0 0 0 0 83 0 0 0 
15 16 15 16 16 16 16 16 16 15 16 16 16 16 16 15 27 0 0 0 0 0 98 98 98 98 0 98 0 98 98 0 98 98 98 98 98 98 98 0 0 0 0 0 0 0 0 0 0 0 0 98 98 0 0 0 0 0 0 98 98 0 0 0 0 0 98 0 0 0 98 0 0 0 0 0 0 0 0 0 0 0 0 0 0 81 0 0 113 0 0 81 0 0 113 0 0 80 0 0 
16 16 15 16 16 15 15 16 16 16 16 16 16 16 16 16 27 98 98 98 98 98 98 98 98 98 98 98 98 98 98 98 98 98 98 98 98 98 0 98 98 0 0 0 0 0 0 0 18 18 0 98 98 0 0 0 0 0 0 0 98 0 0 0 98 0 0 98 98 0 0 0 98 0 0 0 98 98 0 98 98 98 0 0 0 0 81 0 0 81 83 0 80 18 0 0 0 0 81 0 
16 16 16 16 16 15 16 16 16 16 16 16 15 16 16 16 27 0 0 0 0 0 0 0 0 98 0 98 0 0 98 0 0 98 0 98 98 98 0 0 0 98 0 0 0 0 0 0 0 0 0 98 98 0 98 0 0 0 0 0 0 0 0 0 0 0 0 0 0 0 0 0 0 0 0 0 0 0 0 0 0 0 0 0 0 113 0 0 113 0 0 0 0 0 83 0 0 0 0 0 
16 16 16 16 16 16 16 16 16 15 16 16 16 16 16 15 27 0 0 0 0 0 0 0 0 0 0 0 0 0 0 0 0 0 0 0 0 0 0 0 0 0 0 0 0 0 0 0 0 0 0 98 0 0 0 0 0 0 0 0 0 0 0 0 0 0 0 0 0 0 0 0 0 0 0 0 0 0 0 0 0 0 0 0 0 0 81 0 80 0 0 113 113 0 0 81 0 0 113 0 
16 15 16 16 16 16 15 16 16 16 16 16 16 16 15 16 27 0 0 0 0 0 0 0 0 0 0 0 0 0 0 0 0 0 0 0 0 0 0 0 0 0 0 0 0 0 0 0 0 0 0 0 0 0 0 0 0 0 0 0 0 0 0 0 0 0 0 0 0 0 0 0 0 0 0 0 0 0 0 0 0 0 0 0 0 0 113 80 83 83 0 81 0 0 0 0 81 0 0 0 
16 15 16 16 16 16 16 16 16 16 16 16 16 16 16 16 27 0 0 0 0 0 0 0 0 0 0 0 0 0 0 0 0 0 0 0 0 0 0 0 0 0 0 0 0 0 0 0 0 0 0 98 98 0 0 0 0 0 0 0 0 0 0 0 0 0 0 0 0 0 0 0 0 0 0 0 0 0 0 0 0 0 0 0 0 81 0 0 0 0 0 0 113 0 83 0 0 0 0 0 
15 16 16 16 15 16 16 16 16 15 15 16 16 16 16 16 27 0 0 0 0 0 0 0 0 0 0 0 0 0 0 0 0 0 0 0 0 0 0 0 0 0 0 0 0 0 0 0 0 0 0 98 98 0 0 0 0 0 0 0 0 0 0 0 0 0 0 0 0 0 0 0 0 0 0 0 0 0 0 0 0 0 0 0 0 0 113 113 0 81 0 0 0 0 0 0 81 0 0 113 
15 15 16 16 16 16 16 16 16 15 16 16 16 16 16 15 27 0 0 0 0 0 0 0 0 0 0 0 0 0 0 0 0 0 0 0 0 0 0 0 0 0 0 0 0 0 0 0 0 0 0 0 98 0 0 0 0 0 0 0 0 0 0 0 0 0 0 0 0 0 0 0 0 0 0 0 0 0 0 0 0 0 0 0 0 0 81 0 83 0 113 83 0 83 80 0 0 113 0 0 
16 16 16 16 16 15 16 16 16 16 16 16 16 16 15 16 27 0 0 0 0 0 0 0 0 0 0 0 0 0 0 0 0 0 0 0 0 0 0 0 0 0 0 0 0 0 0 0 0 0 0 0 98 98 0 0 0 0 0 0 0 0 0 0 0 0 0 0 0 0 0 0 0 0 0 0 0 0 0 0 0 0 0 0 0 113 83 0 81 0 113 0 0 81 0 0 0 0 83 0 
16 16 16 15 16 16 16 16 16 16 16 16 16 16 16 16 27 0 0 0 0 0 0 0 0 0 0 0 0 0 0 0 0 0 0 0 0 0 0 0 0 0 0 0 0 0 0 0 0 0 0 0 98 0 0 0 0 0 0 0 0 0 0 0 0 0 0 0 0 0 0 0 0 0 0 0 0 0 0 0 0 0 0 0 0 0 81 0 0 0 0 113 0 0 0 113 0 0 0 0 
16 15 16 16 16 15 16 16 15 16 16 16 16 16 16 16 27 0 0 0 0 0 0 0 0 0 0 0 0 0 0 0 0 0 0 0 0 0 0 0 0 0 0 0 0 0 0 0 0 0 0 0 0 0 0 0 0 0 0 0 0 0 0 0 0 0 0 0 0 0 0 0 0 0 0 0 0 0 0 0 0 0 0 0 0 81 0 80 0 83 81 0 0 0 0 0 83 0 81 0 
16 16 16 16 16 16 16 16 16 16 16 15 16 16 16 16 27 0 0 0 0 0 0 0 0 0 0 0 0 0 0 0 0 0 0 0 0 0 0 0 0 0 0 0 0 0 0 0 0 0 0 98 0 0 0 0 0 0 0 0 0 0 0 0 0 0 0 0 0 0 0 0 0 0 0 0 0 0 0 0 0 0 0 0 0 0 113 0 113 81 0 80 0 0 83 0 0 0 0 0 
15 16 16 16 16 16 15 16 16 16 15 16 16 16 15 16 27 0 0 0 0 0 0 0 0 0 0 0 0 0 0 0 0 0 0 0 0 0 0 0 0 0 0 0 0 0 0 0 0 0 0 0 98 0 0 0 0 18 0 0 0 0 0 0 0 0 0 0 0 0 0 0 0 0 0 0 0 0 0 0 0 0 0 0 0 0 81 0 83 83 0 0 81 0 0 0 113 0 0 80 
15 16 15 15 16 16 16 15 16 16 16 16 16 16 16 16 27 0 0 0 0 0 0 0 0 0 0 0 0 0 0 0 0 0 0 0 0 0 0 0 0 0 0 0 0 0 0 0 0 0 0 98 0 0 0 0 0 0 18 0 0 0 0 0 0 0 0 0 0 0 0 0 0 0 0 0 0 0 0 0 0 0 0 0 0 81 0 113 0 81 0 113 80 0 83 0 0 0 0 0 
16 16 16 16 16 15 15 16 15 15 16 16 15 16 16 16 27 0 0 0 0 0 0 0 0 0 0 0 0 0 0 0 0 0 0 0 0 0 0 0 0 0 0 0 0 0 0 0 0 0 0 98 0 0 0 0 0 0 18 0 18 0 0 0 0 0 0 0 0 0 0 0 0 0 0 0 0 0 0 0 0 0 0 0 0 0 113 0 0 83 0 0 0 113 0 0 81 83 0 113 
15 16 16 16 16 16 16 16 16 16 16 16 16 16 15 16 27 0 0 0 0 0 0 0 0 0 0 0 0 0 0 0 0 0 0 0 0 0 0 0 0 0 0 0 0 0 0 0 0 0 0 98 98 0 0 0 0 0 18 0 0 18 0 0 0 0 0 0 0 0 0 0 0 0 0 0 0 0 0 0 0 0 0 0 0 81 0 0 113 0 81 0 0 0 80 0 0 81 0 0 
16 16 16 16 16 16 16 16 16 16 16 16 16 16 16 16 27 0 0 0 0 0 0 0 0 0 0 0 0 0 0 0 0 0 0 0 0 0 0 0 0 0 0 0 0 0 0 0 0 0 0 98 98 0 0 0 0 0 18 0 0 0 18 0 0 0 0 0 0 0 0 0 0 0 0 0 0 0 0 0 0 0 0 0 0 113 81 0 82 0 81 0 0 0 0 113 0 83 0 0 
15 16 16 16 16 15 16 16 16 16 16 16 16 16 16 15 27 0 0 0 0 0 0 0 0 0 0 0 0 0 0 0 0 0 0 0 0 0 0 0 0 0 0 0 0 0 0 0 0 0 0 98 98 0 0 0 0 0 0 0 0 0 0 0 0 0 0 0 0 0 0 0 0 0 0 0 0 0 0 0 0 0 0 0 0 81 0 81 0 0 0 82 80 0 81 0 0 113 83 0 
15 15 15 16 15 16 16 16 16 16 16 15 15 16 16 16 27 0 0 0 0 0 0 0 0 0 0 0 0 0 0 0 0 0 0 0 0 0 0 0 0 0 0 0 0 0 0 0 0 0 0 98 98 0 0 0 0 0 0 0 18 18 0 18 0 0 0 0 0 0 0 0 0 0 0 0 0 0 0 0 0 0 0 0 0 113 0 0 0 113 0 0 0 0 113 0 82 80 0 0 
16 16 16 15 16 15 16 16 16 16 15 16 16 16 16 16 27 0 0 0 0 0 0 0 0 0 0 0 0 0 0 0 0 0 0 0 0 0 0 0 0 0 0 0 0 0 0 0 0 0 0 98 98 0 0 0 0 0 0 0 18 0 18 18 0 0 0 0 0 0 0 0 0 0 0 0 0 0 0 0 0 0 0 0 0 0 81 0 80 0 0 81 0 82 0 0 0 0 81 0 
16 15 16 16 16 16 16 15 16 16 16 16 16 16 15 16 27 0 0 0 0 0 0 0 0 0 0 0 0 0 0 0 0 0 0 0 0 0 0 0 0 0 0 0 0 0 0 0 0 0 0 98 98 0 0 0 0 0 0 0 0 0 0 18 18 0 0 0 0 0 0 0 0 0 0 0 0 0 0 0 0 0 0 0 0 0 81 0 82 0 113 82 0 0 113 0 0 0 0 0 
16 16 16 16 16 16 16 16 16 16 16 16 16 16 16 16 27 0 0 0 0 0 0 0 0 0 0 0 0 0 0 0 0 0 0 0 0 0 0 0 0 0 0 0 0 0 0 0 0 0 0 0 98 0 0 0 0 0 0 0 0 0 0 0 0 0 0 0 0 0 0 0 0 0 0 0 0 0 0 0 0 0 0 0 0 81 0 113 83 0 0 0 0 81 0 0 80 0 0 81 
16 16 16 16 15 16 16 15 16 16 16 16 16 15 16 16 27 0 0 0 0 0 0 0 0 0 0 0 0 0 0 0 0 0 0 0 0 0 0 0 0 0 0 0 0 0 0 0 0 0 0 0 98 0 0 0 0 0 0 0 0 0 0 0 0 0 0 0 0 0 0 0 0 0 0 0 0 0 0 0 0 0 0 0 0 113 81 0 0 113 0 83 0 0 0 113 0 0 81 0 
16 15 15 16 16 15 16 16 15 16 15 16 15 16 16 16 27 0 0 0 0 0 0 0 0 0 0 0 0 0 0 0 0 0 0 0 0 0 0 0 0 0 0 0 0 0 0 0 0 0 0 0 98 0 0 0 0 0 0 0 0 0 0 0 0 0 0 0 0 0 0 0 0 0 0 0 0 0 0 0 0 0 0 0 0 81 0 0 81 0 0 0 82 82 0 0 0 0 0 82 
16 16 16 16 16 16 16 16 16 16 16 15 15 16 16 15 42 43 43 43 43 43 43 43 43 43 43 43 43 43 43 43 43 43 43 43 43 43 43 43 43 43 43 43 43 43 43 43 43 43 43 43 43 43 43 43 43 43 43 43 43 43 43 43 43 43 43 43 43 43 43 43 43 43 43 43 43 43 43 43 43 43 43 43 43 43 43 43 43 43 43 43 43 43 43 43 43 43 43 43 
15 16 16 16 16 15 16 16 16 15 16 16 16 16 15 15 16 16 16 16 16 16 15 16 16 16 16 16 16 16 16 16 16 16 16 16 16 15 16 16 16 16 16 16 16 16 16 16 16 15 16 16 16 16 16 16 16 16 16 15 15 16 16 16 16 16 16 16 16 16 16 16 16 16 16 15 15 16 16 16 16 16 16 16 16 15 16 15 16 16 16 15 16 15 16 16 15 16 16 15 
16 16 16 15 16 16 16 16 16 16 16 16 16 16 16 16 16 16 15 16 16 16 16 16 16 16 16 16 16 16 15 16 16 15 16 16 16 16 16 16 16 15 16 16 16 15 16 16 16 15 16 16 16 15 16 16 16 16 16 16 16 15 16 16 16 16 16 15 16 16 16 16 16 15 16 16 16 16 15 16 16 15 16 16 15 16 16 16 16 16 16 16 16 16 15 16 16 15 16 16 
16 16 16 16 16 15 16 16 15 16 16 15 16 16 15 16 16 16 16 16 15 16 16 15 15 15 15 16 16 16 16 16 16 15 16 16 15 16 16 16 16 16 16 15 15 16 16 16 16 16 16 16 16 16 16 15 16 16 16 16 15 16 16 16 16 16 15 16 16 16 15 16 16 16 16 16 15 16 16 16 15 16 16 16 16 16 16 16 15 16 16 15 16 16 16 15 16 16 16 16 
16 16 16 16 16 16 16 16 16 16 16 16 15 16 16 16 16 16 16 16 16 16 16 16 16 16 16 16 16 16 16 16 16 16 16 16 16 16 16 16 16 16 16 16 16 16 15 16 16 16 16 15 16 16 16 16 16 16 15 16 15 16 16 15 16 16 16 16 15 16 16 16 16 16 16 16 16 16 16 15 16 16 16 15 16 16 15 16 16 16 16 16 16 15 16 16 16 15 16 15 
15 16 16 15 16 16 16 15 16 16 15 16 16 16 15 16 16 16 16 16 16 16 16 15 16 15 15 16 16 16 16 16 16 16 16 16 16 15 15 15 15 15 16 16 16 16 16 16 15 16 16 16 16 16 15 16 16 16 16 16 15 16 16 16 16 15 16 15 16 16 16 16 15 16 15 15 16 16 15 16 16 15 16 16 16 16 16 15 16 16 15 16 16 16 16 15 16 16 16 16 
16 16 16 16 16 15 16 15 16 16 16 16 16 16 16 16 16 16 15 16 16 15 16 16 16 16 16 16 16 15 16 16 16 16 16 16 16 16 16 16 16 16 16 16 16 16 16 16 16 16 16 16 16 16 16 16 15 16 16 16 16 16 15 16 16 16 16 16 16 15 16 16 16 16 16 16 16 16 16 16 15 16 16 15 16 16 15 15 16 16 16 16 15 16 16 16 16 15 16 16 
16 15 16 16 16 16 16 15 16 16 15 16 16 16 16 16 16 16 16 16 15 15 16 16 16 16 16 16 16 16 16 15 16 16 15 16 16 16 15 16 16 16 16 16 16 16 16 16 16 16 15 16 16 16 15 15 16 16 16 16 16 16 16 16 16 16 16 16 16 16 16 16 16 16 16 16 16 16 15 16 16 16 16 16 16 15 16 16 15 15 16 16 15 16 16 16 16 16 16 16 
16 16 16 16 15 16 16 16 16 16 16 16 15 15 16 16 16 15 16 16 16 16 15 15 16 16 16 16 16 16 16 16 15 16 16 16 16 16 16 15 16 16 16 15 16 16 15 16 16 16 16 16 16 16 16 16 16 16 16 16 15 16 15 16 15 16 15 16 15 16 15 16 16 16 15 16 15 16 16 16 16 16 16 16 16 16 16 15 16 16 16 16 16 16 16 15 16 16 16 15 
15 16 15 16 16 16 16 15 16 16 15 16 16 16 15 16 16 16 16 16 16 16 16 16 16 16 15 16 16 16 16 16 16 16 16 16 16 15 15 16 16 16 16 16 16 16 16 16 16 15 16 16 16 16 16 16 15 15 16 16 16 16 16 16 15 16 16 16 16 16 16 15 16 16 16 15 16 15 16 16 16 15 16 16 16 16 16 16 16 16 16 15 16 15 16 16 16 15 16 16 
